揹包	背包
臺	台
映象	鏡像
繫結	綁定
公用事業	公共項目
整型	整數型
型別	類型
坐標	座標
熱鍵	快捷鍵
介面	界面
辅助功能设置…	協助工具設定...
按下Enter键启用复述功能	按下 Enter 以啟用朗讀功能
欢迎进入Minecraft！\n\n需要启用复述功能或访问辅助功能设置吗？	歡迎遊玩 Minecraft！\n\n需要啟用朗讀功能或是調整協助工具設定嗎？
完成	完成
服务器地址	伺服器位址
服务器名称	伺服器名稱
服务器资源包	伺服器資源包
禁用	已停用
启用	已啟用
询问	提示
编辑服务器信息	編輯伺服器資訊
控制台命令	控制台指令
模式	模式
循环	重複
保持开启	永遠啟動
条件制约	有條件
脉冲	脈衝
红石控制	需要紅石
连锁	連鎖
不受制约	無條件
必须是处于创造模式的管理员	必須是創造模式中的管理員
此服务器未启用命令方块	這個伺服器不允許使用指令方塊
上一个输出	先前輸出
设置此方块的控制台命令	設定指令方塊的指令
成功设置命令：%s	指令設為：%s
记录输出	追蹤資料輸出
触发方式	觸發
类型	類型
未知的进度：%s	未知的進度：%s
发现所有的生物群系	發現每個生態域
探索的时光	探險時光
用弩一发击杀五只不同的生物	用弩一擊射殺五種生物
劲弩手	重弩手
在幽匿感测体或监守者周围潜行以防被它们探测到	在伏聆振測器或伏守者附近潛行以避免被偵測
潜行100级	潛行力 100
反弹旋风人的风弹来击杀旋风人	反彈旋風使者的風彈來擊殺它
逆风翻盘	逆風翻盤
用刷子从犰狳身上获得犰狳鳞甲	使用刷子從犰狳身上取得犰狳鱗甲
这不是鳞甲么？	莫非這是鱗甲？
从至少30米外射中标靶的靶心	從至少30公尺外擊中標靶的靶心
正中靶心	正中紅心
用4个陶片制作饰纹陶罐	將四塊陶器碎片組成飾紋陶罐
精修细补	精修細補
靠近一个正在合成合成器的合成器	靠近一台正在合成合成器的合成器
合成器合成合成器	合成器合成合成器
从世界顶部（建筑高度限制处）自由落体，坠至世界底部并存活下来	從世界的最高處（建築高度限制）落至底部並存活
上天入地	洞穴與山崖
将嘎枝之心以正确朝向放在两个苍白橡木原木方块中间	將嘎枝之心以正確方向放置在兩個蒼白橡木原木之間
移心接木	移心接木
成功在袭击中保卫村庄	成功在突襲中守住村莊
村庄英雄	村莊英雄
跳入蜂蜜块以缓冲摔落	跳向蜂蜜塊安全滑落地面
胶着状态	陷入膠著
杀死任意敌对性怪物	殺死任何敵對怪物
怪物猎人	魔物獵人
杀死每一种敌对性怪物	殺死每種敵對怪物各一隻
资深怪物猎人	獵取怪物
在幽匿催发体附近杀死生物	在伏聆觸媒旁殺死生物
它蔓延了	它蔓延了
用斧刮削铜灯来让它变得更亮	用斧頭為銅燈除鏽使其更加明亮
铜光焕发	銅光煥發
在不引发火灾的前提下保护村民免受雷击	保護村民不受雷擊的飛來橫禍，以免發生火災
电涌保护器	突波保護器
踏入试炼密室	踏入試煉密室
Minecraft：试炼版	Minecraft: 試煉版
用弩进行一次射击	用弩發射箭矢
扣下悬刀	扣下扳機
使用重锤一击造成50颗心的伤害	使用重錘一擊造成50顆心的傷害
天赐良击	天賜良擊
用唱片机的音乐声为草甸增添生机	用唱片機的音樂為草甸注入生命力
音乐之声	真善美
使用红石比较器获取雕纹书架的信号强度	使用紅石比較器讀取浮雕書櫃的紅石訊號
知识就是力量	知書就是力量
用不祥试炼钥匙解锁不祥宝库	用不祥試煉鑰匙解鎖不祥寶庫
宝经磨炼	逢凶化吉
冒险、探索与战斗	冒險、探索和戰鬥
冒险	冒險
刷扫可疑的方块来获得陶片	刷拭可疑的方塊以取得陶器碎片
探古寻源	探古尋源
用弓箭射点什么	使用箭矢射擊任何東西
瞄准目标	瞄準
在床上睡觉以改变你的重生点	在床上睡覺以變更您的重生點
甜蜜的梦	甜美的夢
从至少50米外射杀一只骷髅	在距50公尺遠外的地方射殺一隻骷髏
狙击手的对决	狙擊手對決
透过望远镜观察末影龙	使用望遠鏡觀察終界龍
那是飞机吗？	那是飛機嗎？
透过望远镜观察恶魂	使用望遠鏡觀察地獄幽靈
那是气球吗？	那是氣球嗎？
透过望远镜观察鹦鹉	使用望遠鏡觀察鸚鵡
那是鸟吗？	那是鳥嗎？
召唤一只铁傀儡来帮忙守卫村庄	生成一隻鐵魔像以協助保衛村莊
招募援兵	招兵買馬
往什么东西扔出三叉戟。\n注：别把你唯一的武器也抖掉了。	將三叉戟擲向任何物品。\n注意：拋棄你僅有的武器並不是個好主意。
抖包袱	免洗笑話
利用不死图腾逃离死神	使用不死圖騰來逃避死亡
超越生死	超越生死
成功与一名村民进行交易	成功與村民進行交易
成交！	成交！
在建筑高度限制处与村民交易	在建築高度上限與村民交易
星际商人	星際貿易
将下列锻造模板都至少使用一次：尖塔、猪鼻、肋骨、监守、幽静、恼鬼、潮汐、向导	將下列鍛造模板都至少使用一次：旋塔、豬鼻、肋骨、伏守、寂靜、惱鬼、潮汐、嚮導
匠心独具	匠心獨具
在锻造台中合成带有纹饰的盔甲	使用鍛造台合成帶有紋樣的盔甲
旧貌锻新颜	鍛然一新
用一支穿透箭射杀两只幻翼	使用貫穿箭矢一次殺死兩隻夜魅
一箭双雕	一箭雙鵰
用试炼钥匙解锁宝库	用試煉鑰匙解鎖寶庫
珍藏密敛	妥善保管
对着磁石使用指南针	對磁石使用羅盤
天涯共此石	天涯共此石
雷击一名村民	以閃電制裁村民
魔女审判	非常驚世駭俗
杀死一名袭击队长。\n或许该考虑暂时远离村庄……	殺死突襲隊長。\n或許該考慮暫時離村莊遠一點...
自我放逐	自我放逐
在细雪上行走……并且不陷进去	在粉雪上行走... 並且不陷下去
轻功雪上飘	輕功雪上飄
使用风弹将自己向上弹射8格	使用風彈將自己向上彈射 8 格
还要啥火箭啊？	誰還需要火箭？
让掠夺者也尝尝弩的滋味	讓掠奪者自食其果
现在谁才是掠夺者？	現在誰才是掠奪者？
这里好像什么都没有……	這裡似乎什麼都沒有...
用玻璃瓶收集一些龙息	使用玻璃瓶取得龍之吐息
你需要来点薄荷糖	你需要降火氣
获得龙蛋	取得龍蛋
下一世代	銀河飛龍
找到鞘翅	找到鞘翅
天空即为极限	天下無難事
逃离这座岛屿	逃離這座島
远程折跃	逃向遠方
进去吧，又能发生什么呢？	進去吧，還能發生什麼事？
在游戏尽头的城市	終末都市
祝君好运	祝你好運
解放末地	解放終界
利用潜影贝的攻击向上飘浮50个方块	利用界伏蚌的攻擊向上飄浮50格
这上面的风景不错	上面的風景真好
复活末影龙	重生終界龍
结束了…再一次…	終界... 再臨...
抑或是起点？	或是新的開始？
末地	終界
让悦灵向音符盒投掷一块蛋糕	讓悅靈朝音階盒投出一個蛋糕
生日快乐歌	生日快樂歌
让悦灵向你投掷物品	讓悅靈遞送物品給你
找到一个好朋友	我是你好朋友
用铁桶捕获一只美西螈	用鐵桶捕捉一隻六角恐龍
最萌捕食者	最可愛的捕食者
尝遍天下食材，即便是对身体不好的	吃遍所有可以食用的東西，即使它們對你的身體有害
均衡饮食	均衡飲食
繁殖每种动物！	繁殖所有種類的動物！
成双成对	成雙成對
繁殖一对动物	促使動物繁殖
我从哪儿来？	送子鳥的禮物
驯服所有种类的猫！	馴服所有種類的貓！
百猫全书	貓科全書
喂食一只小嗅探兽	餵食一隻幼年嗅探獸
小小嗅探兽	小小嗅探獸
钓到一条鱼	捕獲一條魚
腥味十足的生意	關漁生意
在你的物品栏中集齐所有种类的蛙明灯	在你的物品欄中集齊所有種類的蛙光體
相映生辉！	同心協力！
与美西螈并肩作战并赢得胜利	和六角恐龍結盟並贏得一場戰鬥
友谊的治愈力！	療癒力滿點的友情！
用拴绳拴住所有种类的青蛙	用拴繩牽著所有種類的青蛙
呱呱队出动	蛙軍壓境
让任意种类告示牌上的文本发光	使任意種類告示牌上的文字發光
眼前一亮！	光輝奪目！
用下界合金锭升级一把锄，然后重新考虑你的人生抉择	使用獄髓錠升級一把鋤頭，然後重新衡量你的人生抉擇
终极奉献	敬業樂業
获得嗅探兽蛋	取得嗅探獸蛋
怪味蛋	逸聞趣事
将失水恶魂方块放在水中	將乾癟幽靈放入水中
补水保湿！	補水保濕！
种植任意嗅探兽种子	種植任意嗅探獸種子
播种往事	種種往事
种下种子，见证它的成长	種下一個種子並見證它的成長
开荒垦地	汗滴禾下土
用剪刀移除狼身上的狼铠	使用剪刀移除狼身上的狼鎧
华丽一剪	剪潔俐落
用犰狳鳞甲修复损坏的狼铠	使用犰狳鱗甲完全修復耗損的狼鎧
完好如初	復舊如新
与山羊同船共渡	與山羊一起乘船航行
羊帆起航！	飄羊過海！
世界无处没有朋友与美食	這個世界充滿朋友與食物
农牧业	農牧
利用营火在不惊动蜜蜂的情况下从蜂巢收集蜂蜜	使用營火以在不激怒蜜蜂的情況下用玻璃瓶從蜂窩中取得蜂蜜
与蜂共舞	待客蜂範
用精准采集移动住着3只蜜蜂的蜂巢或蜂箱	使用絲綢之觸來移動裡面有3隻蜜蜂的蜂窩或蜂箱
举巢搬迁	蜂裝物流
不用钓鱼竿抓住一条鱼！	釣魚... 不用釣竿！
战术性钓鱼	戰術性捕魚
用铁桶捕获一只蝌蚪	用鐵桶捕捉一隻蝌蚪
蚪到桶里来	通通進桶
驯服一只动物	馴服一隻動物
永恒的伙伴	永遠的好搭檔
给铜质方块脱蜡！	刮除銅方塊上的蠟！
脱蜡	除蠟
将蜜脾涂到铜质方块上！	為銅方塊塗上蜂蠟！
涂蜡	上蠟
驯服所有种类的狼	馴服所有種類的狼
群狼聚首	琳狼滿目
同时拥有所有状态效果	同時擁有所有狀態效果
为什么会变成这样呢？	我們是如何走到這地步的？
同时拥有所有药水效果	同時擁有所有藥水的效果
狂乱的鸡尾酒	猛烈的雞尾酒
酿造一瓶药水	釀造一瓶藥水
本地酿造厂	道地的釀造坊
为重生锚充满能量	將重生錨充滿能量
锚没有九条命	非言「九」命
建造并放置一个信标	建造及放置烽火台
带信标回家	為家庭帶來光明
让一座信标发挥最大功效	令烽火台全力運作
信标工程师	引導者
用金质物品让猪灵分神	用黃金使豬布林分心
金光闪闪	金光閃閃
探索所有下界生物群系	探索地獄所有的生態域
热门景点	熱門景點
利用下界移动对应主世界7千米的距离	利用地獄在主世界旅行至七公里外
曲速泡	子空間氣泡
进入堡垒遗迹	進入堡壘遺蹟
光辉岁月	今非昔比
用你的方式进入下界要塞	用自己的方式進入地獄要塞
阴森的要塞	可怕的要塞
获得凋灵骷髅的头颅	取得凋零骷髏的頭顱
惊悚恐怖骷髅头	詭異又恐怖的骷髏
掠夺堡垒遗迹里的箱子	掠奪一個堡壘遺蹟裡的儲物箱
战猪	戰豬
获得一整套下界合金盔甲	取得全套獄髓盔甲
残骸裹身	以瓦礫為壁壘
获得远古残骸	取得遠古遺骸
深藏不露	深藏不露
让烈焰人从烈焰棒中解放吧	讓烈焰使者從烈焰桿中解脫
与火共舞	與火共舞
获得哭泣的黑曜石	取得哭泣的黑曜石
谁在切洋葱？	是誰在切洋蔥？
用一团火球干掉一只恶魂	使用火球殺死地獄幽靈
见鬼去吧	以牙還牙
手持诡异菌钓竿骑乘炽足兽	利用扭曲蕈菇釣竿騎乘熾足獸
画船添足	行舟
带炽足兽在主世界的熔岩湖上来一场长——途旅行	在主世界的熔岩湖上和熾足獸來一段長～～途旅行
温暖如家	溫暖如家
记得带夏装	攜帶夏季服飾
下界	地獄
召唤凋灵	召喚凋零怪
凋零山庄	凋零山莊
从下界救出一只恶魂，将其安全地带到主世界……然后干掉它	將地獄幽靈從地獄安全的救回主世界 ... 然後讓它解脫
脆弱的同盟	不安的同盟
%s/%s	%s/%s
:(	:(
弱化并治疗一名僵尸村民	弱化並治好一位殭屍村民
僵尸科医生	殭屍醫生
用盾牌反弹一个弹射物	使用盾牌反彈投射物
不吃这套，谢谢	抱歉，今天不行
用附魔台附魔一样物品	使用附魔台附魔一件物品
附魔师	附魔師
进入末地传送门	進入終界傳送門
结束了？	結束了？
建造、激活并进入一座下界传送门	建造、點燃並進入地獄傳送門
勇往直下	我們必須更深入一點
跟随末影之眼	跟隨終界之眼
隔墙有眼	隔牆有眼
获得一块黑曜石	取得一塊黑曜石
冰桶挑战	冰桶挑戰
升级你的镐	升級你的鎬
这不是铁镐么	莫非這是鐵鎬
用铁桶装点熔岩	把熔岩裝進鐵桶
热腾腾的	火熱的東西
获得钻石	獲得鑽石
钻石！	鑽石！
用你的新镐挖掘石头	用你的新鎬子挖掘石頭
石器时代	石器時代
用铁盔甲来保护你自己	使用鐵製盔甲保護自己
整装上阵	整裝待發
游戏的核心与故事	遊戲的核心與故事
Minecraft	Minecraft
钻石盔甲能救人	鑽石盔甲救人一命
钻石护体	用鑽石包覆我
冶炼出一块铁锭	冶煉出鐵錠
来硬的	來硬的
制作一把更好的镐	製作一把更好的鎬
获得升级	獲取升級
挑战已完成！	挑戰達成！
目标已达成！	目標達成！
进度已达成！	進度達成！
无效的实体锚点%s	無效的實體錨點 %s
不完整（应有1个角度）	不完整（應有 1 個角度）
无效的角度	無效的角度
未知的方块类型“%s”	未知的方塊類型 '%s'
“%s”属性只能给%s设置一次	%2$s 方塊的屬性 '%1$s' 只能設定一次
%1$s的%3$s属性不能被设为“%2$s”	%s 方塊不接受以 '%s' 作為 %s 的屬性
方块%s上的属性“%s”必须要有值	%2$s 方塊的屬性 '%1$s' 應為值
方块属性应以]结束	方塊狀態屬性後應以 ] 結尾
方块%s没有属性“%s”	%s 方塊沒有屬性 '%s'
无法在此使用标签，只允许使用实际的方块	這裡無法使用標籤，只能用於實際方塊
未知的颜色“%s”	未知的顏色 '%s'
无效的聊天组件： %s	無效的聊天元件：%s
未知的准则“%s”	未知的條件 '%s'
未知的维度“%s”	未知的維度 '%s'
双精度浮点型数据不能大于%s，但发现了%s	倍精度浮點數不能多於 %s，但找到的是 %s
双精度浮点型数据不能小于%s，但发现了%s	倍精度浮點數不能少於 %s，但找到的是 %s
无效的名称或UUID	無效的名稱或 UUID
未找到实体	未找到任何實體
未找到玩家	未找到任何玩家
玩家拥有的进度	玩家擁有進度
与实体间的距离	與實體間的距離
距离不能为负	距離不能為負數
位于x与x+dx之间的实体	位於 x 和 x + dx 之間的實體
位于y与y+dy之间的实体	位於 y 和 y + dy 之間的實體
位于z与z+dz之间的实体	位於 z 和 z + dz 之間的實體
玩家的游戏模式	玩家於遊戲模式
“%s”选项不适用于这里	此處不適用 '%s' 選項
经验等级	經驗等級
等级不应该为负数	等級不應為負數
最大返回实体数	最大回傳實體數
限制必须至少为1	限制必須至少為 1
无效或未知的游戏模式“%s”	無效或未知的遊戲模式 '%s'
实体名称	實體名稱
实体所带的NBT	實體擁有 NBT
自定义谓词	自訂述詞
实体的分数	實體擁有分數
对实体排序	對實體進行排序
无效或未知的排序类型“%s”	無效或未知的排序類型 '%s'
实体所带的标签	實體擁有標籤
实体所在的队伍	實體於隊伍
实体类型	實體類型
无效或未知的实体类型“%s”	無效或未知的實體類型 '%s'
未知的选项“%s”	未知的選項 '%s'
选项的方括号不成对	選項應有結尾
选项“%s”应有值	選項 '%s' 應為數值
X轴位置	x 座標
实体的X轴旋转角度	實體的 x 軸方向
Y轴位置	y 座標
实体的Y轴旋转角度	實體的 y 軸方向
Z轴位置	z 座標
所有实体	所有實體
所有玩家	所有玩家
缺少选择器类型	缺少選擇器類型
距离最近的实体	最接近的實體
距离最近的玩家	最接近的玩家
不能使用选择器	選擇器無法使用
随机玩家	隨機玩家
当前实体	目前實體
未知的选择器类型“%s”	未知的選擇器類型 '%s'
只允许一个实体，但提供的选择器允许多个实体	僅接受單一實體，但提供的選擇器允許不只一個實體
无效的值“%s”	無效數值「%s」
浮点型数据不能大于%s，但发现了%s	單精度浮點數不能多於 %s，但找到的是 %s
浮点型数据不能小于%s，但发现了%s	單精度浮點數不能少於 %s，但找到的是 %s
未知的游戏模式：%s	未知的遊戲模式：%s
无效的十六进制颜色代码：“%s”	無效的十六進位顏色碼 '%s'
无效的ID	無效的 ID
未知的ID：%s	未知的 ID: %s
整型数据不能大于%s，但发现了%s	整數不能多於 %s，但找到的是 %s
整型数据不能小于%s，但发现了%s	整數不能少於 %s，但找到的是 %s
未知的物品“%s”	未知的物品 '%s'
无法在此使用标签，只允许使用实际的物品	這裡無法使用標籤，只能用於實際物品
应为字面量%s	應為字面值 %s
长整型数据不能大于%s，但发现了%s	長整數不能多於 %s，但找到的是 %s
长整型数据不能小于%s，但发现了%s	長整數不能少於 %s，但找到的是 %s
聊天消息过长（%s大于上限%s个字符）	聊天訊息過長（%s 大於最大值 %s 個字元）
无效的数组类型“%s”	無效的陣列類型 '%s'
无法将%s插入%s	無法將 %s 插入至 %s
应为复合标签	應為複合標籤
需要键	應為鍵值
需要值	應為數值
无法将%s插入%s的列表	無法將 %s 插入至清單 %s
多余的尾随数据	多餘的尾隨資料
只有玩家会受此命令的影响，但提供的选择器包括其他实体	只有玩家能受這條指令影響，但提供的選擇器包含了其他實體
只允许一名玩家，但提供的选择器允许多名玩家	僅接受單一玩家，但提供的選擇器允許不只一個玩家
该玩家不存在	該玩家不存在
应为一个坐标	應為座標
应为一个方块的位置	應為方塊座標
不能混用世界与局部坐标（必须全部用^或都不使用）	不能混用世界與局部座標（必須全部都用 ^ 或是完全不用）
该位置超出了允许的范围。	該位置位於允許的範圍外。
该位置已超出此世界！	該座標位於世界外！
该位置尚未被加载	該座標尚未載入
不完整（应有2个坐标）	不完整（應有 2 個座標）
不完整（应有3个坐标）	不完整（應有 3 個座標）
应为值或取值范围	應為數值或數值的範圍
只允许整数，不允许小数	只允許整數，不能為小數
最小值不能大于最大值	最小值不能大於最大值
元素“%s”的类型“%s”错误（应为“%s”）	元素 '%s' 擁有錯誤類型 '%s' （應為 '%s' ）
无法找到类型为“%2$s”的元素“%1$s”	無法找到類型為 '%2$s' 的元素 '%1$s'
解析结构失败：%s	無法剖析結構：%s
无效的ID或标签	無效的 ID 或標籤
无法在注册表“%2$s”中找到元素“%1$s”	無法在登錄 '%2$s' 中找到元素 '%1$s'
选择器“%s”和类型“%s”没有匹配项	選擇器 '%s' 與類型 '%s' 沒有相符的項目
标签“%s”的类型“%s”错误（应为“%s”）	標籤 '%s' 擁有錯誤類型 '%s' （應為 '%s' ）
无法找到类型为“%2$s”的标签“%1$s”	無法找到類型為 '%2$s' 的標籤 '%1$s'
找不到与分数关联的持有者	無法找到該分數相對應的持有者
未知的显示位置“%s”	未知的顯示區 '%s'
无效的样式：%s	無效的樣式：%s
刻数必须为非负数	刻數不可為負數
无效的单位	無效的單位
刻数不能小于%s，却发现了%s	刻數不能少於 %s，但找到的是 %s
无效的UUID	無效的 UUID
选择的实体不是路径点	選擇的實體不是路徑點
未知的方块标签“%s”	未知的方塊標籤 '%s'
未知的函数标签“%s”	未知的函數標籤 '%s'
未知的函数%s	未知的函數 %s
应为物品组件	應為物品元件
错误的“%s”组件：“%s”	錯誤的 '%s' 元件：'%s'
物品组件“%s”重复，只能指定一个值	物品元件 '%s' 重複，只能指定一個值
未知的物品组件“%s”	未知的物品元件 '%s'
错误的物品：“%s”	錯誤的物品：'%s'
%s只可以堆叠到%s	%s 只能堆疊至 %s
错误的“%s”谓词：“%s”	錯誤的 '%s' 述詞：'%s'
未知的物品谓词“%s”	未知的物品述詞 '%s'
未知的物品标签“%s”	未知的物品標籤 '%s'
无效的NBT路径元素	無效的 NBT 路徑元素
没有与%s相匹配的元素	找不到與 %s 相符的元素
生成的NBT嵌套过深	產生的 NBT 巢套過深
生成的NBT过大	產生的 NBT 過大
未知的记分项“%s”	未知的計分板目標 '%s'
记分项“%s”为只读类型	計分板目標 '%s' 是唯讀的
不能除以零	無法除以零
无效的操作	無效的操作
无效的坐标组合，需要“x”、“y”和“z”的组合	無效的搭配，應為 'x'、'y' 與 'z' 的組合
%s %s	%s %s
%s%% %s	%s%% %s
+%s %s	+%s %s
+%s%% %s	+%s%% %s
-%s %s	-%s %s
-%s%% %s	-%s%% %s
护甲值	盔甲
盔甲韧性	盔甲強度
攻击伤害	攻擊傷害
击退	擊退
攻击速度	攻擊速度
方块破坏速度	方塊破壞速度
方块交互距离	方塊互動距離
着火时间	燃燒時間
镜头距离	鏡頭距離
实体交互距离	實體互動距離
爆炸击退抗性	抗爆炸擊退
摔落伤害倍数	摔落傷害倍率
飞行速度	飛行速度
生物跟随距离	生物追蹤範圍
重力	重力
跳跃力度	跳躍力
击退抗性	抗擊退
幸运值	幸運
最大伤害吸收值	最大傷害吸收值
最大生命值	最高生命值
移动效率	移動效率
速度	速度
额外氧气	額外氧氣
安全摔落高度	安全摔落高度
尺寸	大小
最大行走高度	最大行走高度
水中移动效率	水中移動效率
马匹跳跃能力	馬跳躍力
挖掘效率	挖掘效率
潜行速度	潛行速度
水下挖掘速度	水中挖掘速度
横扫伤害比率	橫掃傷害率
僵尸增援	殭屍增援隊
生物引诱范围	生物引誘範圍
路径点接收距离	路徑點接收距離
路径点传输距离	路徑點傳輸距離
恶地	惡地
竹林	竹林
玄武岩三角洲	玄武岩三角洲
沙滩	沙灘
桦木森林	樺木森林
樱花树林	櫻花樹林
冷水海洋	寒冷海洋
绯红森林	緋紅森林
黑森林	黑森林
冷水深海	寒冷深海
深暗之域	深淵
冰冻深海	寒凍深海
温水深海	溫和深海
深海	深海
沙漠	沙漠
溶洞	鐘乳石洞窟
末地荒地	終界荒地
末地高地	終界高地
末地内陆	終界平地
风蚀恶地	侵蝕惡地
繁花森林	繁花森林
森林	森林
冻洋	寒凍海洋
冰封山峰	霜凍山峰
冻河	寒凍河流
雪林	雪林
冰刺之地	冰刺
尖峭山峰	尖峭山峰
丛林	叢林
温水海洋	溫和海洋
繁茂洞穴	蒼鬱洞窟
红树林沼泽	紅樹林沼澤
草甸	草甸
蘑菇岛	蘑菇地
下界荒地	地獄荒原
海洋	海洋
原始桦木森林	原生樺木森林
原始松木针叶林	原生松木針葉林
原始云杉针叶林	原生杉木針葉林
苍白之园	蒼白之園
平原	平原
河流	河流
热带草原	莽原
热带高原	莽原高地
末地小型岛屿	終界小島
积雪沙滩	冰雪沙灘
雪原	雪原
积雪山坡	雪坡
积雪针叶林	冰雪針葉林
灵魂沙峡谷	靈魂砂谷
稀疏丛林	稀疏叢林
裸岩山峰	裸岩山峰
石岸	石岸
向日葵平原	向日葵平原
沼泽	沼澤
针叶林	針葉林
虚空	虛空
暖水海洋	溫暖海洋
诡异森林	扭曲森林
风袭森林	風蝕森林
风袭沙砾丘陵	風蝕礫質丘陵
风袭丘陵	風蝕丘陵
风袭热带草原	風蝕莽原
疏林恶地	疏林惡地
金合欢木按钮	相思木按鈕
金合欢木门	相思木門
金合欢木栅栏	相思木柵欄
金合欢木栅栏门	相思木柵欄門
悬挂式金合欢木告示牌	懸掛式相思木告示牌
金合欢树叶	相思木樹葉
金合欢原木	相思木原木
金合欢木板	相思木材
金合欢木压力板	相思木壓力板
金合欢树苗	相思木樹苗
金合欢木展示架	相思木展示架
金合欢木告示牌	相思木告示牌
金合欢木台阶	相思木半磚
金合欢木楼梯	相思木階梯
金合欢木活板门	相思木地板門
墙上的悬挂式金合欢木告示牌	牆上的懸掛式相思木告示牌
墙上的金合欢木告示牌	牆上的相思木告示牌
金合欢木	相思木塊
激活铁轨	觸發鐵軌
空气	空氣
绒球葱	紫紅球花
紫水晶块	紫水晶方塊
紫水晶簇	紫水晶晶簇
远古残骸	遠古遺骸
安山岩	安山岩
安山岩台阶	安山岩半磚
安山岩楼梯	安山岩階梯
安山岩墙	安山岩牆
铁砧	鐵砧
结果的西瓜茎	連接的西瓜梗
结果的南瓜茎	連接的南瓜梗
杜鹃花丛	杜鵑叢
杜鹃树叶	杜鵑葉
蓝花美耳草	雛草
竹子	竹子
竹块	竹方塊
竹按钮	竹按鈕
竹门	竹門
竹栅栏	竹柵欄
竹栅栏门	竹柵欄門
悬挂式竹告示牌	懸掛式竹告示牌
竹马赛克	竹拼塊
竹马赛克台阶	竹拼半磚
竹马赛克楼梯	竹拼階梯
竹板	竹材
竹压力板	竹壓力板
竹笋	竹筍
竹展示架	竹展示架
竹告示牌	竹告示牌
竹台阶	竹半磚
竹楼梯	竹階梯
竹活板门	竹地板門
墙上的悬挂式竹告示牌	牆上的懸掛式竹告示牌
墙上的竹告示牌	牆上的竹告示牌
黑底	黑色基底
蓝底	藍色基底
棕底	棕色基底
青底	青色基底
灰底	灰色基底
绿底	綠色基底
淡蓝底	淺藍色基底
淡灰底	淺灰色基底
黄绿底	淺綠色基底
品红底	洋紅色基底
橙底	橙色基底
粉红底	粉紅色基底
紫底	紫色基底
红底	紅色基底
白底	白色基底
黄底	黃色基底
黑色方框边	黑色框邊
蓝色方框边	藍色框邊
棕色方框边	棕色框邊
青色方框边	青色框邊
灰色方框边	灰色框邊
绿色方框边	綠色框邊
淡蓝色方框边	淺藍色框邊
淡灰色方框边	淺灰色框邊
黄绿色方框边	淺綠色框邊
品红色方框边	洋紅色框邊
橙色方框边	橙色框邊
粉红色方框边	粉紅色框邊
紫色方框边	紫色框邊
红色方框边	紅色框邊
白色方框边	白色框邊
黄色方框边	黃色框邊
黑色砖纹	黑色磚牆花紋
蓝色砖纹	藍色磚牆花紋
棕色砖纹	棕色磚牆花紋
青色砖纹	青色磚牆花紋
灰色砖纹	灰色磚牆花紋
绿色砖纹	綠色磚牆花紋
淡蓝色砖纹	淺藍色磚牆花紋
淡灰色砖纹	淺灰色磚牆花紋
黄绿色砖纹	淺綠色磚牆花紋
品红色砖纹	洋紅色磚牆花紋
橙色砖纹	橙色磚牆花紋
粉红色砖纹	粉紅色磚牆花紋
紫色砖纹	紫色磚牆花紋
红色砖纹	紅色磚牆花紋
白色砖纹	白色磚牆花紋
黄色砖纹	黃色磚牆花紋
黑色圆形	黑色圓形
蓝色圆形	藍色圓形
棕色圆形	棕色圓形
青色圆形	青色圓形
灰色圆形	灰色圓形
绿色圆形	綠色圓形
淡蓝色圆形	淺藍色圓形
淡灰色圆形	淺灰色圓形
黄绿色圆形	淺綠色圓形
品红色圆形	洋紅色圓形
橙色圆形	橙色圓形
粉红色圆形	粉紅色圓形
紫色圆形	紫色圓形
红色圆形	紅色圓形
白色圆形	白色圓形
黄色圆形	黃色圓形
黑色苦力怕盾徽	黑色苦力怕圖紋
蓝色苦力怕盾徽	藍色苦力怕圖紋
棕色苦力怕盾徽	棕色苦力怕圖紋
青色苦力怕盾徽	青色苦力怕圖紋
灰色苦力怕盾徽	灰色苦力怕圖紋
绿色苦力怕盾徽	綠色苦力怕圖紋
淡蓝色苦力怕盾徽	淺藍色苦力怕圖紋
淡灰色苦力怕盾徽	淺灰色苦力怕圖紋
黄绿色苦力怕盾徽	淺綠色苦力怕圖紋
品红色苦力怕盾徽	洋紅色苦力怕圖紋
橙色苦力怕盾徽	橙色苦力怕圖紋
粉红色苦力怕盾徽	粉紅色苦力怕圖紋
紫色苦力怕盾徽	紫色苦力怕圖紋
红色苦力怕盾徽	紅色苦力怕圖紋
白色苦力怕盾徽	白色苦力怕圖紋
黄色苦力怕盾徽	黃色苦力怕圖紋
黑斜十字	黑色對角交叉
蓝斜十字	藍色對角交叉
棕斜十字	棕色對角交叉
青斜十字	青色對角交叉
灰斜十字	灰色對角交叉
绿斜十字	綠色對角交叉
淡蓝斜十字	淺藍色對角交叉
淡灰斜十字	淺灰色對角交叉
黄绿斜十字	淺綠色對角交叉
品红斜十字	洋紅色對角交叉
橙斜十字	橙色對角交叉
粉红斜十字	粉紅色對角交叉
紫斜十字	紫色對角交叉
红斜十字	紅色對角交叉
白斜十字	白色對角交叉
黄斜十字	黃色對角交叉
黑色波纹边	黑色鋸齒框邊
蓝色波纹边	藍色鋸齒框邊
棕色波纹边	棕色鋸齒框邊
青色波纹边	青色鋸齒框邊
灰色波纹边	灰色鋸齒框邊
绿色波纹边	綠色鋸齒框邊
淡蓝色波纹边	淺藍色鋸齒框邊
淡灰色波纹边	淺灰色鋸齒框邊
黄绿色波纹边	淺綠色鋸齒框邊
品红色波纹边	洋紅色鋸齒框邊
橙色波纹边	橙色鋸齒框邊
粉红色波纹边	粉紅色鋸齒框邊
紫色波纹边	紫色鋸齒框邊
红色波纹边	紅色鋸齒框邊
白色波纹边	白色鋸齒框邊
黄色波纹边	黃色鋸齒框邊
黑色右上三角	左上方黑色填滿
蓝色右上三角	左上方藍色填滿
棕色右上三角	左上方棕色填滿
青色右上三角	左上方青色填滿
灰色右上三角	左上方灰色填滿
绿色右上三角	左上方綠色填滿
淡蓝色右上三角	左上方淺藍色填滿
淡灰色右上三角	左上方淺灰色填滿
黄绿色右上三角	左上方淺綠色填滿
品红色右上三角	左上方洋紅色填滿
橙色右上三角	左上方橙色填滿
粉红色右上三角	左上方粉紅色填滿
紫色右上三角	左上方紫色填滿
红色右上三角	左上方紅色填滿
白色右上三角	左上方白色填滿
黄色右上三角	左上方黃色填滿
黑色左上三角	右上方黑色填滿
蓝色左上三角	右上方藍色填滿
棕色左上三角	右上方棕色填滿
青色左上三角	右上方青色填滿
灰色左上三角	右上方灰色填滿
绿色左上三角	右上方綠色填滿
淡蓝色左上三角	右上方淺藍色填滿
淡灰色左上三角	右上方淺灰色填滿
黄绿色左上三角	右上方淺綠色填滿
品红色左上三角	右上方洋紅色填滿
橙色左上三角	右上方橙色填滿
粉红色左上三角	右上方粉紅色填滿
紫色左上三角	右上方紫色填滿
红色左上三角	右上方紅色填滿
白色左上三角	右上方白色填滿
黄色左上三角	右上方黃色填滿
黑色右下三角	左下方黑色填滿
蓝色右下三角	左下方藍色填滿
棕色右下三角	左下方棕色填滿
青色右下三角	左下方青色填滿
灰色右下三角	左下方灰色填滿
绿色右下三角	左下方綠色填滿
淡蓝色右下三角	左下方淺藍色填滿
淡灰色右下三角	左下方淺灰色填滿
黄绿色右下三角	左下方淺綠色填滿
品红色右下三角	左下方洋紅色填滿
橙色右下三角	左下方橙色填滿
粉红色右下三角	左下方粉紅色填滿
紫色右下三角	左下方紫色填滿
红色右下三角	左下方紅色填滿
白色右下三角	左下方白色填滿
黄色右下三角	左下方黃色填滿
黑色左下三角	右下方黑色填滿
蓝色左下三角	右下方藍色填滿
棕色左下三角	右下方棕色填滿
青色左下三角	右下方青色填滿
灰色左下三角	右下半部分灰色填滿
绿色左下三角	右下方綠色填滿
淡蓝色左下三角	右下半部分淺藍色填滿
淡灰色左下三角	右下方淺灰色填滿
黄绿色左下三角	右下半部分淺綠色填滿
品红色左下三角	右下方洋紅色填滿
橙色左下三角	右下方橙色填滿
粉红色左下三角	右下方粉紅色填滿
紫色左下三角	右下方紫色填滿
红色左下三角	右下方紅色填滿
白色左下三角	右下方白色填滿
黄色左下三角	右下方黃色填滿
黑色涡流	黑色渦流
蓝色涡流	藍色渦流
棕色涡流	棕色渦流
青色涡流	青色渦流
灰色涡流	灰色渦流
绿色涡流	綠色渦流
淡蓝色涡流	淺藍色渦流
淡灰色涡流	淺灰色渦流
黄绿色涡流	淺綠色渦流
品红色涡流	洋紅色渦流
橙色涡流	橙色渦流
粉红色涡流	粉紅色渦流
紫色涡流	紫色渦流
红色涡流	紅色渦流
白色涡流	白色渦流
黄色涡流	黃色渦流
黑色花朵盾徽	黑色花朵圖紋
蓝色花朵盾徽	藍色花朵圖紋
棕色花朵盾徽	棕色花朵圖紋
青色花朵盾徽	青色花朵圖紋
灰色花朵盾徽	灰色花朵圖紋
绿色花朵盾徽	綠色花朵圖紋
淡蓝色花朵盾徽	淺藍色花朵圖紋
淡灰色花朵盾徽	淺灰色花朵圖紋
黄绿色花朵盾徽	淺綠色花朵圖紋
品红色花朵盾徽	洋紅色花朵圖紋
橙色花朵盾徽	橙色花朵圖紋
粉红色花朵盾徽	粉紅色花朵圖紋
紫色花朵盾徽	紫色花朵圖紋
红色花朵盾徽	紅色花朵圖紋
白色花朵盾徽	白色花朵圖紋
黄色花朵盾徽	黃色花朵圖紋
黑色地球	黑色地球
蓝色地球	藍色地球
棕色地球	棕色地球
青色地球	青色地球
灰色地球	灰色地球
绿色地球	綠色地球
淡蓝色地球	淺藍色地球
淡灰色地球	淺灰色地球
黄绿色地球	淺綠色地球
品红色地球	洋紅色地球
橙色地球	橙色地球
粉红色地球	粉紅色地球
紫色地球	紫色地球
红色地球	紅色地球
白色地球	白色地球
黄色地球	黃色地球
黑色自上渐淡	黑色往下漸淡
蓝色自上渐淡	藍色往下漸淡
棕色自上渐淡	棕色往下漸淡
青色自上渐淡	青色往下漸淡
灰色自上渐淡	灰色往下漸淡
绿色自上渐淡	綠色往下漸淡
淡蓝色自上渐淡	淺藍色往下漸淡
淡灰色自上渐淡	淺灰色往下漸淡
黄绿色自上渐淡	淺綠色往下漸淡
品红色自上渐淡	洋紅色往下漸淡
橙色自上渐淡	橙色往下漸淡
粉红色自上渐淡	粉紅色往下漸淡
紫色自上渐淡	紫色往下漸淡
红色自上渐淡	紅色往下漸淡
白色自上渐淡	白色往下漸淡
黄色自上渐淡	黃色往下漸淡
黑色自下渐淡	黑色往上漸淡
蓝色自下渐淡	藍色往上漸淡
棕色自下渐淡	棕色往上漸淡
青色自下渐淡	青色往上漸淡
灰色自下渐淡	灰色往上漸淡
绿色自下渐淡	綠色往上漸淡
淡蓝色自下渐淡	淺藍色往上漸淡
淡灰色自下渐淡	淺灰色往上漸淡
黄绿色自下渐淡	淺綠色往上漸淡
品红色自下渐淡	洋紅色往上漸淡
橙色自下渐淡	橙色往上漸淡
粉红色自下渐淡	粉紅色往上漸淡
紫色自下渐淡	紫色往上漸淡
红色自下渐淡	紅色往上漸淡
白色自下渐淡	白色往上漸淡
黄色自下渐淡	黃色往上漸淡
黑色旋风	黑色狂風
蓝色旋风	藍色狂風
棕色旋风	棕色狂風
青色旋风	青色狂風
灰色旋风	灰色狂風
绿色旋风	綠色狂風
淡蓝色旋风	淺藍色狂風
淡灰色旋风	淺灰色狂風
黄绿色旋风	淺綠色狂風
品红色旋风	洋紅色狂風
橙色旋风	橙色狂風
粉红色旋风	粉紅色狂風
紫色旋风	紫色狂風
红色旋风	紅色狂風
白色旋风	白色狂風
黄色旋风	黃色狂風
黑色上半方形	上半部分黑色填滿
蓝色上半方形	上半部分藍色填滿
棕色上半方形	上半部分棕色填滿
青色上半方形	上半部分青色填滿
灰色上半方形	上半部分灰色填滿
绿色上半方形	上半部分綠色填滿
淡蓝色上半方形	上半部分淺藍色填滿
淡灰色上半方形	上半部分淺灰色填滿
黄绿色上半方形	上半部分淺綠色填滿
品红色上半方形	上半部分洋紅色填滿
橙色上半方形	上半部分橙色填滿
粉红色上半方形	上半部分粉紅色填滿
紫色上半方形	上半部分紫色填滿
红色上半方形	上半部分紅色填滿
白色上半方形	上半部分白色填滿
黄色上半方形	上半部分黃色填滿
黑色下半方形	下半部分黑色填滿
蓝色下半方形	下半部分藍色填滿
棕色下半方形	下半部分棕色填滿
青色下半方形	下半部分青色填滿
灰色下半方形	下半部分灰色填滿
绿色下半方形	下半部分綠色填滿
淡蓝色下半方形	下半部分淺藍色填滿
淡灰色下半方形	下半部分淺灰色填滿
黄绿色下半方形	下半部分淺綠色填滿
品红色下半方形	下半部分洋紅色填滿
橙色下半方形	下半部分橙色填滿
粉红色下半方形	下半部分粉紅色填滿
紫色下半方形	下半部分紫色填滿
红色下半方形	下半部分紅色填滿
白色下半方形	下半部分白色填滿
黄色下半方形	下半部分黃色填滿
黑色右半方形	左半部分黑色填滿
蓝色右半方形	左半部分藍色填滿
棕色右半方形	左半部分棕色填滿
青色右半方形	左半部分青色填滿
灰色右半方形	左半部分灰色填滿
绿色右半方形	左半部分綠色填滿
淡蓝色右半方形	左半部分淺藍色填滿
淡灰色右半方形	左半部分淺灰色填滿
黄绿色右半方形	左半部分淺綠色填滿
品红色右半方形	左半部分洋紅色填滿
橙色右半方形	左半部分橙色填滿
粉红色右半方形	左半部分粉紅色填滿
紫色右半方形	左半部分紫色填滿
红色右半方形	左半部分紅色填滿
白色右半方形	左半部分白色填滿
黄色右半方形	左半部分黃色填滿
黑色左半方形	右半部分黑色填滿
蓝色左半方形	右半部分藍色填滿
棕色左半方形	右半部分棕色填滿
青色左半方形	右半部分青色填滿
灰色左半方形	右半部分灰色填滿
绿色左半方形	右半部分綠色填滿
淡蓝色左半方形	右半部分淺藍色填滿
淡灰色左半方形	右半部分淺灰色填滿
黄绿色左半方形	右半部分淺綠色填滿
品红色左半方形	右半部分洋紅色填滿
橙色左半方形	右半部分橙色填滿
粉红色左半方形	右半部分粉紅色填滿
紫色左半方形	右半部分紫色填滿
红色左半方形	右半部分紅色填滿
白色左半方形	右半部分白色填滿
黄色左半方形	右半部分黃色填滿
黑色Mojang徽标	黑色 Mojang 標誌
蓝色Mojang徽标	藍色 Mojang 標誌
棕色Mojang徽标	棕色 Mojang 標誌
青色Mojang徽标	青色 Mojang 標誌
灰色Mojang徽标	灰色 Mojang 標誌
绿色Mojang徽标	綠色 Mojang 標誌
淡蓝色Mojang徽标	淺藍色 Mojang 標誌
淡灰色Mojang徽标	淺灰色 Mojang 標誌
黄绿色Mojang徽标	淺綠色 Mojang 標誌
品红色Mojang徽标	洋紅色 Mojang 標誌
橙色Mojang徽标	橙色 Mojang 標誌
粉红色Mojang徽标	粉紅色 Mojang 標誌
紫色Mojang徽标	紫色 Mojang 標誌
红色Mojang徽标	紅色 Mojang 標誌
白色Mojang徽标	白色 Mojang 標誌
黄色Mojang徽标	黃色 Mojang 標誌
黑色猪鼻	黑色豬鼻
蓝色猪鼻	藍色豬鼻
棕色猪鼻	棕色豬鼻
青色猪鼻	青色豬鼻
灰色猪鼻	灰色豬鼻
绿色猪鼻	綠色豬鼻
淡蓝色猪鼻	淺藍色豬鼻
淡灰色猪鼻	淺灰色豬鼻
黄绿色猪鼻	淺綠色豬鼻
品红色猪鼻	洋紅色豬鼻
橙色猪鼻	橙色豬鼻
粉红色猪鼻	粉紅色豬鼻
紫色猪鼻	紫色豬鼻
红色猪鼻	紅色豬鼻
白色猪鼻	白色豬鼻
黄色猪鼻	黃色豬鼻
黑色菱形	黑色菱形
蓝色菱形	藍色菱形
棕色菱形	棕色菱形
青色菱形	青色菱形
灰色菱形	灰色菱形
绿色菱形	綠色菱形
淡蓝色菱形	淺藍色菱形
淡灰色菱形	淺灰色菱形
黄绿色菱形	淺綠色菱形
品红色菱形	洋紅色菱形
橙色菱形	橙色菱形
粉红色菱形	粉紅色菱形
紫色菱形	紫色菱形
红色菱形	紅色菱形
白色菱形	白色菱形
黄色菱形	黃色菱形
黑色头颅盾徽	黑色骷髏圖紋
蓝色头颅盾徽	藍色骷髏圖紋
棕色头颅盾徽	棕色骷髏圖紋
青色头颅盾徽	青色骷髏圖紋
灰色头颅盾徽	灰色骷髏圖紋
绿色头颅盾徽	綠色骷髏圖紋
淡蓝色头颅盾徽	淺藍色骷髏圖紋
淡灰色头颅盾徽	淺灰色骷髏圖紋
黄绿色头颅盾徽	淺綠色骷髏圖紋
品红色头颅盾徽	洋紅色骷髏圖紋
橙色头颅盾徽	橙色骷髏圖紋
粉红色头颅盾徽	粉紅色骷髏圖紋
紫色头颅盾徽	紫色骷髏圖紋
红色头颅盾徽	紅色骷髏圖紋
白色头颅盾徽	白色骷髏圖紋
黄色头颅盾徽	黃色骷髏圖紋
黑竖条纹	黑色垂直條紋
蓝竖条纹	藍色垂直條紋
棕竖条纹	棕色垂直條紋
青竖条纹	青色垂直條紋
灰竖条纹	灰色垂直條紋
绿竖条纹	綠色垂直條紋
淡蓝竖条纹	淺藍色垂直條紋
淡灰竖条纹	淺灰色垂直條紋
黄绿竖条纹	淺綠色垂直條紋
品红竖条纹	洋紅色垂直條紋
橙竖条纹	橙色垂直條紋
粉红竖条纹	粉紅色垂直條紋
紫竖条纹	紫色垂直條紋
红竖条纹	紅色垂直條紋
白竖条纹	白色垂直條紋
黄竖条纹	黃色垂直條紋
右底黑方	左下黑色矩形
右底蓝方	左下藍色矩形
右底棕方	左下棕色矩形
右底青方	左下青色矩形
右底灰方	左下灰色矩形
右底绿方	左下綠色矩形
右底淡蓝方	左下淺藍色矩形
右底淡灰方	左下淺灰色矩形
右底黄绿方	左下淺綠色矩形
右底品红方	左下洋紅色矩形
右底橙方	左下橙色矩形
右底粉红方	左下粉紅色矩形
右底紫方	左下紫色矩形
右底红方	左下紅色矩形
右底白方	左下白色矩形
右底黄方	左下黃色矩形
左底黑方	右下黑色矩形
左底蓝方	右下藍色矩形
左底棕方	右下棕色矩形
左底青方	右下青色矩形
左底灰方	右下灰色矩形
左底绿方	右下綠色矩形
左底淡蓝方	右下淺藍色矩形
左底淡灰方	右下淺灰色矩形
左底黄绿方	右下淺綠色矩形
左底品红方	右下洋紅色矩形
左底橙方	右下橙色矩形
左底粉红方	右下粉紅色矩形
左底紫方	右下紫色矩形
左底红方	右下紅色矩形
左底白方	右下白色矩形
左底黄方	右下黃色矩形
右顶黑方	左上黑色矩形
右顶蓝方	左上藍色矩形
右顶棕方	左上棕色矩形
右顶青方	左上青色矩形
右顶灰方	左上灰色矩形
右顶绿方	左上綠色矩形
右顶淡蓝方	左上淺藍色矩形
右顶淡灰方	左上淺灰色矩形
右顶黄绿方	左上淺綠色矩形
右顶品红方	左上洋紅色矩形
右顶橙方	左上橙色矩形
右顶粉红方	左上粉紅色矩形
右顶紫方	左上紫色矩形
右顶红方	左上紅色矩形
右顶白方	左上白色矩形
右顶黄方	左上黃色矩形
左顶黑方	右上黑色矩形
左顶蓝方	右上藍色矩形
左顶棕方	右上棕色矩形
左顶青方	右上青色矩形
左顶灰方	右上灰色矩形
左顶绿方	右上綠色矩形
左顶淡蓝方	右上淺藍色矩形
左顶淡灰方	右上淺灰色矩形
左顶黄绿方	右上淺綠色矩形
左顶品红方	右上洋紅色矩形
左顶橙方	右上橙色矩形
左顶粉红方	右上粉紅色矩形
左顶紫方	右上紫色矩形
左顶红方	右上紅色矩形
左顶白方	右上白色矩形
左顶黄方	右上黃色矩形
黑正十字	黑色十字
蓝正十字	藍色十字
棕正十字	棕色十字
青正十字	青色十字
灰正十字	灰色十字
绿正十字	綠色十字
淡蓝正十字	淺藍色十字
淡灰正十字	淺灰色十字
黄绿正十字	淺綠色十字
品红正十字	洋紅色十字
橙正十字	橙色十字
粉红正十字	粉紅色十字
紫正十字	紫色十字
红正十字	紅色十字
白正十字	白色十字
黄正十字	黃色十字
底黑横条	黑色底部
底蓝横条	藍色底部
底棕横条	棕色底部
底青横条	青色底部
底灰横条	灰色底部
底绿横条	綠色底部
底淡蓝横条	淺藍色底部
底淡灰横条	淺灰色底部
底黄绿横条	淺綠色底部
底品红横条	洋紅色底部
底橙横条	橙色底部
底粉红横条	粉紅色底部
底紫横条	紫色底部
底红横条	紅色底部
底白横条	白色底部
底黄横条	黃色底部
中黑竖条	中間黑色縱帶
中蓝竖条	中間藍色縱帶
中棕竖条	中間棕色縱帶
中青竖条	中間青色縱帶
中灰竖条	中間灰色縱帶
中绿竖条	中間綠色縱帶
中淡蓝竖条	中間淺藍色縱帶
中淡灰竖条	中間淺灰色縱帶
中黄绿竖条	中間淺綠色縱帶
中品红竖条	中間洋紅色縱帶
中橙竖条	中間橙色縱帶
中粉红竖条	中間粉紅色縱帶
中紫竖条	中間紫色縱帶
中红竖条	中間紅色縱帶
中白竖条	中間白色縱帶
中黄竖条	中間黃色縱帶
左黑斜条	左斜黑色對角帶
左蓝斜条	左斜藍色對角帶
左棕斜条	左斜棕色對角帶
左青斜条	左斜青色對角帶
左灰斜条	左斜灰色對角帶
左绿斜条	左斜綠色對角帶
左淡蓝斜条	左斜淺藍色對角帶
左淡灰斜条	左斜淺灰色對角帶
左黄绿斜条	左斜淺綠色對角帶
左品红斜条	左斜洋紅色對角帶
左橙斜条	左斜橙色對角帶
左粉红斜条	左斜粉紅色對角帶
左紫斜条	左斜紫色對角帶
左红斜条	左斜紅色對角帶
左白斜条	左斜白色對角帶
左黄斜条	左斜黃色對角帶
右黑斜条	右斜黑色對角帶
右蓝斜条	右斜藍色對角帶
右棕斜条	右斜棕色對角帶
右青斜条	右斜青色對角帶
右灰斜条	右斜灰色對角帶
右绿斜条	右斜綠色對角帶
右淡蓝斜条	右斜淺藍色對角帶
右淡灰斜条	右斜淺灰色對角帶
右黄绿斜条	右斜淺綠色對角帶
右品红斜条	右斜洋紅色對角帶
右橙斜条	右斜橙色對角帶
右粉红斜条	右斜粉紅色對角帶
右紫斜条	右斜紫色對角帶
右红斜条	右斜紅色對角帶
右白斜条	右斜白色對角帶
右黄斜条	右斜黃色對角帶
右黑竖条	左方黑色縱帶
右蓝竖条	左方藍色縱帶
右棕竖条	左方棕色縱帶
右青竖条	左方青色縱帶
右灰竖条	左方灰色縱帶
右绿竖条	左方綠色縱帶
右淡蓝竖条	左方淺藍色縱帶
右淡灰竖条	左方淺灰色縱帶
右黄绿竖条	左方淺綠色縱帶
右品红竖条	左方洋紅色縱帶
右橙竖条	左方橙色縱帶
右粉红竖条	左方粉紅色縱帶
右紫竖条	左方紫色縱帶
右红竖条	左方紅色縱帶
右白竖条	左方白色縱帶
右黄竖条	左方黃色縱帶
中黑横条	中間黑色橫帶
中蓝横条	中間藍色橫帶
中棕横条	中間棕色橫帶
中青横条	中間青色橫帶
中灰横条	中間灰色橫帶
中绿横条	中間綠色橫帶
中淡蓝横条	中間淺藍色橫帶
中淡灰横条	中間淺灰色橫帶
中黄绿横条	中間淺綠色橫帶
中品红横条	中間洋紅色橫帶
中橙横条	中間橙色橫帶
中粉红横条	中間粉紅色橫帶
中紫横条	中間紫色橫帶
中红横条	中間紅色橫帶
中白横条	中間白色橫帶
中黄横条	中間黃色橫帶
左黑竖条	右方黑色縱帶
左蓝竖条	右方藍色縱帶
左棕竖条	右方棕色縱帶
左青竖条	右方青色縱帶
左灰竖条	右方灰色縱帶
左绿竖条	右方綠色縱帶
左淡蓝竖条	右方淺藍色縱帶
左淡灰竖条	右方淺灰色縱帶
左黄绿竖条	右方淺綠色縱帶
左品红竖条	右方洋紅色縱帶
左橙竖条	右方橙色縱帶
左粉红竖条	右方粉紅色縱帶
左紫竖条	右方紫色縱帶
左红竖条	右方紅色縱帶
左白竖条	右方白色縱帶
左黄竖条	右方黃色縱帶
顶黑横条	黑色頂部
顶蓝横条	藍色頂部
顶棕横条	棕色頂部
顶青横条	青色頂部
顶灰横条	灰色頂部
顶绿横条	綠色頂部
顶淡蓝横条	淺藍色頂部
顶淡灰横条	淺灰色頂部
顶黄绿横条	淺綠色頂部
顶品红横条	洋紅色頂部
顶橙横条	橙色頂部
顶粉红横条	粉紅色頂部
顶紫横条	紫色頂部
顶红横条	紅色頂部
顶白横条	白色頂部
顶黄横条	黃色頂部
底黑三角	下方黑色三角形
底蓝三角	下方藍色三角形
底棕三角	下方棕色三角形
底青三角	下方青色三角形
底灰三角	下方灰色三角形
底绿三角	下方綠色三角形
底淡蓝三角	下方淺藍色三角形
底淡灰三角	下方淺灰色三角形
底黄绿三角	下方淺綠色三角形
底品红三角	下方洋紅色三角形
底橙三角	下方橙色三角形
底粉红三角	下方粉紅色三角形
底紫三角	下方紫色三角形
底红三角	下方紅色三角形
底白三角	下方白色三角形
底黄三角	下方黃色三角形
顶黑三角	上方黑色倒三角形
顶蓝三角	上方藍色倒三角形
顶棕三角	上方棕色倒三角形
顶青三角	上方青色倒三角形
顶灰三角	上方灰色倒三角形
顶绿三角	上方綠色倒三角形
顶淡蓝三角	上方淺藍色倒三角形
顶淡灰三角	上方淺灰色倒三角形
顶黄绿三角	上方淺綠色倒三角形
顶品红三角	上方洋紅色倒三角形
顶橙三角	上方橙色倒三角形
顶粉红三角	上方粉紅色倒三角形
顶紫三角	上方紫色倒三角形
顶红三角	上方紅色倒三角形
顶白三角	上方白色倒三角形
顶黄三角	上方黃色倒三角形
黑色底波纹	下側黑色鋸齒
蓝色底波纹	下側藍色鋸齒
棕色底波纹	下側棕色鋸齒
青色底波纹	下側青色鋸齒
灰色底波纹	下側灰色鋸齒
绿色底波纹	下側綠色鋸齒
淡蓝色底波纹	下側淺藍色鋸齒
淡灰色底波纹	下側淺灰色鋸齒
黄绿色底波纹	下側淺綠色鋸齒
品红色底波纹	下側洋紅色鋸齒
橙色底波纹	下側橙色鋸齒
粉红色底波纹	下側粉紅色鋸齒
紫色底波纹	下側紫色鋸齒
红色底波纹	下側紅色鋸齒
白色底波纹	下側白色鋸齒
黄色底波纹	下側黃色鋸齒
黑色顶波纹	上側黑色鋸齒
蓝色顶波纹	上側藍色鋸齒
棕色顶波纹	上側棕色鋸齒
青色顶波纹	上側青色鋸齒
灰色顶波纹	上側灰色鋸齒
绿色顶波纹	上側綠色鋸齒
淡蓝色顶波纹	上側淺藍色鋸齒
淡灰色顶波纹	上側淺灰色鋸齒
黄绿色顶波纹	上側淺綠色鋸齒
品红色顶波纹	上側洋紅色鋸齒
橙色顶波纹	上側橙色鋸齒
粉红色顶波纹	上側粉紅色鋸齒
紫色顶波纹	上側紫色鋸齒
红色顶波纹	上側紅色鋸齒
白色顶波纹	上側白色鋸齒
黄色顶波纹	上側黃色鋸齒
木桶	木桶
屏障	屏障
玄武岩	玄武岩
信标	烽火台
主效果	主要效果
辅助效果	次要效果
你只能在夜间或雷暴中入眠	你只能在晚上或暴風雨中入睡
你现在不能休息，周围有怪物在游荡	你現在無法休息，附近有怪物在遊蕩
这张床已被阻挡	這張床受到阻擋
这张床已被占用	這張床已被占用
你现在不能休息，床太远了	現在無法休息，你離床太遠了
基岩	基岩
蜂巢	蜂窩
蜂箱	蜂箱
甜菜根	甜菜根
钟	鐘
大型垂滴叶	大懸葉草
大型垂滴叶茎	大懸葉草葉柄
白桦木按钮	樺木按鈕
白桦木门	樺木門
白桦木栅栏	樺木柵欄
白桦木栅栏门	樺木柵欄門
悬挂式白桦木告示牌	懸掛式樺木告示牌
白桦树叶	樺木樹葉
白桦原木	樺木原木
白桦木板	樺木材
白桦木压力板	樺木壓力板
白桦树苗	樺木樹苗
白桦木展示架	樺木展示架
白桦木告示牌	樺木告示牌
白桦木台阶	樺木半磚
白桦木楼梯	樺木階梯
白桦木活板门	樺木地板門
墙上的悬挂式白桦木告示牌	牆上的懸掛式樺木告示牌
墙上的白桦木告示牌	牆上的樺木告示牌
白桦木	樺木塊
黑色旗帜	黑色旗幟
黑色床	黑色床
黑色蜡烛	黑色蠟燭
插上黑色蜡烛的蛋糕	插上黑色蠟燭的蛋糕
黑色地毯	黑色地毯
黑色混凝土	黑色混凝土
黑色混凝土粉末	黑色混凝土粉末
黑色带釉陶瓦	黑色釉陶
黑色潜影盒	黑色界伏盒
黑色染色玻璃	黑色玻璃
黑色染色玻璃板	黑色玻璃片
黑色陶瓦	黑色陶土
黑色羊毛	黑色羊毛
黑石	黑石
黑石台阶	黑石半磚
黑石楼梯	黑石階梯
黑石墙	黑石牆
高炉	高爐
蓝色旗帜	藍色旗幟
蓝色床	藍色床
蓝色蜡烛	藍色蠟燭
插上蓝色蜡烛的蛋糕	插上藍色蠟燭的蛋糕
蓝色地毯	藍色地毯
蓝色混凝土	藍色混凝土
蓝色混凝土粉末	藍色混凝土粉末
蓝色带釉陶瓦	藍色釉陶
蓝冰	藍冰
兰花	藍色蝴蝶蘭
蓝色潜影盒	藍色界伏盒
蓝色染色玻璃	藍色玻璃
蓝色染色玻璃板	藍色玻璃片
蓝色陶瓦	藍色陶土
蓝色羊毛	藍色羊毛
骨块	骨塊
书架	書櫃
脑纹珊瑚	腦珊瑚
脑纹珊瑚块	腦珊瑚方塊
脑纹珊瑚扇	扇狀腦珊瑚
墙上的脑纹珊瑚扇	牆上的扇狀腦珊瑚
酿造台	釀造台
红砖台阶	紅磚半磚
红砖楼梯	紅磚階梯
红砖墙	紅磚牆
红砖块	紅磚
棕色旗帜	棕色旗幟
棕色床	棕色床
棕色蜡烛	棕色蠟燭
插上棕色蜡烛的蛋糕	插上棕色蠟燭的蛋糕
棕色地毯	棕色地毯
棕色混凝土	棕色混凝土
棕色混凝土粉末	棕色混凝土粉末
棕色带釉陶瓦	棕色釉陶
棕色蘑菇	棕色蘑菇
棕色蘑菇方块	棕色蘑菇方塊
棕色潜影盒	棕色界伏盒
棕色染色玻璃	棕色玻璃
棕色染色玻璃板	棕色玻璃片
棕色陶瓦	棕色陶土
棕色羊毛	棕色羊毛
气泡柱	氣泡柱
气泡珊瑚	氣泡珊瑚
气泡珊瑚块	氣泡珊瑚方塊
气泡珊瑚扇	扇狀氣泡珊瑚
墙上的气泡珊瑚扇	牆上的扇狀氣泡珊瑚
紫水晶母岩	紫水晶芽床
灌木丛	灌木叢
仙人掌	仙人掌
仙人掌花	仙人掌花
蛋糕	蛋糕
方解石	方解石
校频幽匿感测体	校準伏聆振測器
营火	營火
蜡烛	蠟燭
插上蜡烛的蛋糕	插上蠟燭的蛋糕
胡萝卜	胡蘿蔔
制图台	製圖台
雕刻南瓜	雕刻過的南瓜
炼药锅	鍋釜
洞穴空气	洞穴空氣
洞穴藤蔓	洞穴藤蔓
洞穴藤蔓植株	洞穴藤蔓植株
锁链	鎖鏈
连锁型命令方块	連鎖式指令方塊
樱花木按钮	櫻花木按鈕
樱花木门	櫻花木門
樱花木栅栏	櫻花木柵欄
樱花木栅栏门	櫻花木柵欄門
悬挂式樱花木告示牌	懸掛式櫻花木告示牌
樱花树叶	櫻花木樹葉
樱花原木	櫻花木原木
樱花木板	櫻花木材
樱花木压力板	櫻花木壓力板
樱花树苗	櫻花木樹苗
樱花木展示架	櫻花木展示架
樱花木告示牌	櫻花木告示牌
樱花木台阶	櫻花木半磚
樱花木楼梯	櫻花木階梯
樱花木活板门	櫻花木地板門
墙上的悬挂式樱花木告示牌	牆上的懸掛式櫻花木告示牌
墙上的樱花木告示牌	牆上的櫻花木告示牌
樱花木	櫻花木塊
箱子	儲物箱
开裂的铁砧	微損的鐵砧
雕纹书架	浮雕書櫃
雕纹铜块	浮雕銅方塊
雕纹深板岩	浮雕深板岩
雕纹下界砖块	浮雕地獄磚
雕纹磨制黑石	浮雕拋光黑石
雕纹石英块	浮雕石英方塊
雕纹红砂岩	浮雕紅砂岩
雕纹树脂砖块	浮雕樹脂磚
雕纹砂岩	浮雕砂岩
雕纹石砖	浮雕石磚
雕纹凝灰岩	浮雕凝灰岩
雕纹凝灰岩砖	浮雕凝灰岩磚
紫颂花	歌萊花
紫颂植株	歌萊枝
黏土	黏土
闭合的眼眸花	閉合的擬目花
煤炭块	煤炭方塊
煤矿石	煤礦
砂土	粗泥
深板岩圆石	深板岩碎石
深板岩圆石台阶	碎深板岩半磚
深板岩圆石楼梯	碎深板岩階梯
深板岩圆石墙	碎深板岩牆
圆石	鵝卵石
圆石台阶	鵝卵石半磚
圆石楼梯	鵝卵石階梯
圆石墙	鵝卵石牆
蜘蛛网	蜘蛛網
可可果	可可豆
命令方块	指令方塊
红石比较器	紅石比較器
堆肥桶	堆肥箱
潮涌核心	海靈核心
铜块	銅方塊
铜灯	銅燈
铜箱子	銅儲物箱
铜门	銅門
铜傀儡像	銅像
铜格栅	銅格柵
铜矿石	銅礦
铜活板门	銅地板門
矢车菊	矢車菊
裂纹深板岩砖	裂紋深板岩磚
裂纹深板岩瓦	裂紋深板岩磚瓦
裂纹下界砖块	裂紋地獄磚
裂纹磨制黑石砖	裂紋拋光黑石磚
裂纹石砖	裂紋石磚
合成器	合成器
工作台	工作台
嘎枝之心	嘎枝之心
苦力怕的头	苦力怕頭顱
墙上的苦力怕的头	牆上的苦力怕頭顱
绯红木按钮	緋紅蕈木按鈕
绯红木门	緋紅蕈木門
绯红木栅栏	緋紅蕈木柵欄
绯红木栅栏门	緋紅蕈木柵欄門
绯红菌	緋紅蕈菇
悬挂式绯红木告示牌	懸掛式緋紅蕈木告示牌
绯红菌核	緋紅菌絲體
绯红菌岩	緋紅菌絲石
绯红木板	緋紅蕈木材
绯红木压力板	緋紅蕈木壓力板
绯红菌索	緋紅蕈根
绯红木展示架	緋紅蕈木物品架
绯红木告示牌	緋紅蕈木告示牌
绯红木台阶	緋紅蕈木半磚
绯红木楼梯	緋紅蕈木階梯
绯红菌柄	緋紅蕈柄
绯红木活板门	緋紅蕈木地板門
墙上的悬挂式绯红木告示牌	牆上的懸掛式緋紅蕈木告示牌
墙上的绯红木告示牌	牆上的緋紅蕈木告示牌
哭泣的黑曜石	哭泣的黑曜石
切制铜块	切製銅方塊
切制铜台阶	切製銅半磚
切制铜楼梯	切製銅階梯
切制红砂岩	切製紅砂岩
切制红砂岩台阶	切製紅砂岩半磚
切制砂岩	切製砂岩
切制砂岩台阶	切製砂岩半磚
青色旗帜	青色旗幟
青色床	青色床
青色蜡烛	青色蠟燭
插上青色蜡烛的蛋糕	插上青色蠟燭的蛋糕
青色地毯	青色地毯
青色混凝土	青色混凝土
青色混凝土粉末	青色混凝土粉末
青色带釉陶瓦	青色釉陶
青色潜影盒	青色界伏盒
青色染色玻璃	青色玻璃
青色染色玻璃板	青色玻璃片
青色陶瓦	青色陶土
青色羊毛	青色羊毛
损坏的铁砧	耗損的鐵砧
蒲公英	蒲公英
深色橡木按钮	黑橡木按鈕
深色橡木门	黑橡木門
深色橡木栅栏	黑橡木柵欄
深色橡木栅栏门	黑橡木柵欄門
悬挂式深色橡木告示牌	懸掛式黑橡木告示牌
深色橡树树叶	黑橡木樹葉
深色橡木原木	黑橡木原木
深色橡木木板	黑橡木材
深色橡木压力板	黑橡木壓力板
深色橡树树苗	黑橡木樹苗
深色橡木展示架	黑橡木物品架
深色橡木告示牌	黑橡木告示牌
深色橡木台阶	黑橡木半磚
深色橡木楼梯	黑橡木階梯
深色橡木活板门	黑橡木地板門
墙上的悬挂式深色橡木告示牌	牆上的懸掛式黑橡木告示牌
墙上的深色橡木告示牌	牆上的黑橡木告示牌
深色橡木	黑橡木塊
暗海晶石	暗海磷石
暗海晶石台阶	暗海磷石半磚
暗海晶石楼梯	暗海磷石階梯
阳光探测器	日光感測器
失活的脑纹珊瑚	死亡的腦珊瑚
失活的脑纹珊瑚块	死亡的腦珊瑚方塊
失活的脑纹珊瑚扇	死亡的扇狀腦珊瑚
墙上的失活脑纹珊瑚扇	牆上死亡的扇狀腦珊瑚
失活的气泡珊瑚	死亡的氣泡珊瑚
失活的气泡珊瑚块	死亡的氣泡珊瑚方塊
失活的气泡珊瑚扇	死亡的扇狀氣泡珊瑚
墙上的失活气泡珊瑚扇	牆上死亡的扇狀氣泡珊瑚
枯萎的灌木	枯灌木
失活的火珊瑚	死亡的火珊瑚
失活的火珊瑚块	死亡的火珊瑚方塊
失活的火珊瑚扇	死亡的扇狀火珊瑚
墙上的失活火珊瑚扇	牆上死亡的扇狀火珊瑚
失活的鹿角珊瑚	死亡的角珊瑚
失活的鹿角珊瑚块	死亡的角珊瑚方塊
失活的鹿角珊瑚扇	死亡的扇狀角珊瑚
墙上的失活鹿角珊瑚扇	牆上死亡的扇狀角珊瑚
失活的管珊瑚	死亡的管珊瑚
失活的管珊瑚块	死亡的管珊瑚方塊
失活的管珊瑚扇	死亡的扇狀管珊瑚
墙上的失活管珊瑚扇	牆上死亡的扇狀管珊瑚
饰纹陶罐	飾紋陶罐
深板岩	深板岩
深板岩砖台阶	深板岩磚半磚
深板岩砖楼梯	深板岩磚階梯
深板岩砖墙	深板岩磚牆
深板岩砖	深板岩磚
深层煤矿石	深板岩煤礦
深层铜矿石	深板岩銅礦
深层钻石矿石	深板岩鑽石礦
深层绿宝石矿石	深板岩綠寶石礦
深层金矿石	深板岩金礦
深层铁矿石	深板岩鐵礦
深层青金石矿石	深板岩青金石礦
深层红石矿石	深板岩紅石礦
深板岩瓦台阶	深板岩磚瓦半磚
深板岩瓦楼梯	深板岩磚瓦階梯
深板岩瓦墙	深板岩磚瓦牆
深板岩瓦	深板岩磚瓦
探测铁轨	感測鐵軌
钻石块	鑽石方塊
钻石矿石	鑽石礦
闪长岩	閃長岩
闪长岩台阶	閃長岩半磚
闪长岩楼梯	閃長岩階梯
闪长岩墙	閃長岩牆
泥土	泥土
土径	土徑
发射器	發射器
龙蛋	龍蛋
龙首	龍首
墙上的龙首	牆上的龍首
失水恶魂	乾癟幽靈
干海带块	海帶乾塊
滴水石块	鐘乳石方塊
投掷器	投擲器
绿宝石块	綠寶石方塊
绿宝石矿石	綠寶石礦
附魔台	附魔台
末地折跃门	終界折躍門
末地传送门	終界傳送門
末地传送门框架	終界傳送門框架
末地烛	終界燭
末地石	終界石
末地石砖台阶	終界石磚半磚
末地石砖楼梯	終界石磚階梯
末地石砖墙	終界石磚牆
末地石砖	終界石磚
末影箱	終界箱
斑驳的雕纹铜块	斑駁的浮雕銅方塊
斑驳的铜块	斑駁的銅方塊
斑驳的铜灯	斑駁的銅燈
斑驳的铜箱子	斑駁的銅儲物箱
斑驳的铜门	斑駁的銅門
斑驳的铜傀儡像	斑駁的銅像
斑驳的铜格栅	斑駁的銅格柵
斑驳的铜活板门	斑駁的銅地板門
斑驳的切制铜块	斑駁的切製銅方塊
斑驳的切制铜台阶	斑駁的切製銅半磚
斑驳的切制铜楼梯	斑駁的切製銅階梯
斑驳的避雷针	斑駁的避雷針
耕地	耕地
蕨	蕨
火	火
火珊瑚	火珊瑚
火珊瑚块	火珊瑚方塊
火珊瑚扇	扇狀火珊瑚
墙上的火珊瑚扇	牆上的扇狀火珊瑚
萤火虫灌木丛	螢火蟲灌木叢
制箭台	製箭台
花盆	花盆
盛开的杜鹃花丛	開花的杜鵑叢
盛开的杜鹃树叶	開花的杜鵑葉
青蛙卵	青蛙卵
霜冰	霜冰
熔炉	熔爐
镶金黑石	鑲金黑石
玻璃	玻璃
玻璃板	玻璃片
发光地衣	發光地衣
荧石	螢光石
金块	黃金方塊
金矿石	金礦
花岗岩	花崗岩
花岗岩台阶	花崗岩半磚
花岗岩楼梯	花崗岩階梯
花岗岩墙	花崗岩牆
草	草
草方块	草地
沙砾	礫石
灰色旗帜	灰色旗幟
灰色床	灰色床
灰色蜡烛	灰色蠟燭
插上灰色蜡烛的蛋糕	插上灰色蠟燭的蛋糕
灰色地毯	灰色地毯
灰色混凝土	灰色混凝土
灰色混凝土粉末	灰色混凝土粉末
灰色带釉陶瓦	灰色釉陶
灰色潜影盒	灰色界伏盒
灰色染色玻璃	灰色玻璃
灰色染色玻璃板	灰色玻璃片
灰色陶瓦	灰色陶土
灰色羊毛	灰色羊毛
绿色旗帜	綠色旗幟
绿色床	綠色床
绿色蜡烛	綠色蠟燭
插上绿色蜡烛的蛋糕	插上綠色蠟燭的蛋糕
绿色地毯	綠色地毯
绿色混凝土	綠色混凝土
绿色混凝土粉末	綠色混凝土粉末
绿色带釉陶瓦	綠色釉陶
绿色潜影盒	綠色界伏盒
绿色染色玻璃	綠色玻璃
绿色染色玻璃板	綠色玻璃片
绿色陶瓦	綠色陶土
绿色羊毛	綠色羊毛
砂轮	砂輪
垂根	懸根
干草捆	乾草捆
沉重核心	沉重核心
重质测重压力板	重質測重壓力板
蜂蜜块	蜂蜜塊
蜜脾块	蜂巢塊
漏斗	漏斗
鹿角珊瑚	角珊瑚
鹿角珊瑚块	角珊瑚方塊
鹿角珊瑚扇	扇狀角珊瑚
墙上的鹿角珊瑚扇	牆上的扇狀角珊瑚
冰	冰
虫蚀雕纹石砖	蛀蝕的浮雕石磚
虫蚀圆石	蛀蝕的鵝卵石
虫蚀裂纹石砖	蛀蝕的裂紋石磚
虫蚀深板岩	蛀蝕的深板岩
虫蚀苔石砖	蛀蝕的青苔石磚
虫蚀石头	蛀蝕的石頭
虫蚀石砖	蛀蝕的石磚
铁栏杆	鐵柵欄
铁块	鐵方塊
铁门	鐵門
铁矿石	鐵礦
铁活板门	鐵地板門
南瓜灯	南瓜燈
拼图方块	拼圖方塊
唱片机	唱片機
丛林木按钮	叢林木按鈕
丛林木门	叢林木門
丛林木栅栏	叢林木柵欄
丛林木栅栏门	叢林木柵欄門
悬挂式丛林木告示牌	懸掛式叢林木告示牌
丛林树叶	叢林木樹葉
丛林原木	叢林木原木
丛林木板	叢林木材
丛林木压力板	叢林木壓力板
丛林树苗	叢林木樹苗
丛林木展示架	叢林木物品架
丛林木告示牌	叢林木告示牌
丛林木台阶	叢林木半磚
丛林木楼梯	叢林木階梯
丛林木活板门	叢林木地板門
墙上的悬挂式丛林木告示牌	牆上的懸掛式叢林木告示牌
墙上的丛林木告示牌	牆上的叢林木告示牌
丛林木	叢林木塊
海带	海帶
海带植株	海帶植株
梯子	梯子
灯笼	燈籠
青金石块	青金石方塊
青金石矿石	青金石礦
大型紫晶芽	大型紫水晶芽
大型蕨	大型蕨類
熔岩	熔岩
装有熔岩的炼药锅	裝熔岩的鍋釜
枯叶	枯葉
讲台	講台
拉杆	控制桿
光源方块	光源
淡蓝色旗帜	淺藍色旗幟
淡蓝色床	淺藍色床
淡蓝色蜡烛	淺藍色蠟燭
插上淡蓝色蜡烛的蛋糕	插上淺藍色蠟燭的蛋糕
淡蓝色地毯	淺藍色地毯
淡蓝色混凝土	淺藍色混凝土
淡蓝色混凝土粉末	淺藍色混凝土粉末
淡蓝色带釉陶瓦	淺藍色釉陶
淡蓝色潜影盒	淺藍色界伏盒
淡蓝色染色玻璃	淺藍色玻璃
淡蓝色染色玻璃板	淺藍色玻璃片
淡蓝色陶瓦	淺藍色陶土
淡蓝色羊毛	淺藍色羊毛
淡灰色旗帜	淺灰色旗幟
淡灰色床	淺灰色床
淡灰色蜡烛	淺灰色蠟燭
插上淡灰色蜡烛的蛋糕	插上淺灰色蠟燭的蛋糕
淡灰色地毯	淺灰色地毯
淡灰色混凝土	淺灰色混凝土
淡灰色混凝土粉末	淺灰色混凝土粉末
淡灰色带釉陶瓦	淺灰色釉陶
淡灰色潜影盒	淺灰色界伏盒
淡灰色染色玻璃	淺灰色玻璃
淡灰色染色玻璃板	淺灰色玻璃片
淡灰色陶瓦	淺灰色陶土
淡灰色羊毛	淺灰色羊毛
轻质测重压力板	輕質測重壓力板
避雷针	避雷針
丁香	紫丁香
铃兰	鈴蘭
睡莲	荷葉
黄绿色旗帜	淺綠色旗幟
黄绿色床	淺綠色床
黄绿色蜡烛	淺綠色蠟燭
插上黄绿色蜡烛的蛋糕	插上淺綠色蠟燭的蛋糕
黄绿色地毯	淺綠色地毯
黄绿色混凝土	淺綠色混凝土
黄绿色混凝土粉末	淺綠色混凝土粉末
黄绿色带釉陶瓦	淺綠色釉陶
黄绿色潜影盒	淺綠色界伏盒
黄绿色染色玻璃	淺綠色玻璃
黄绿色染色玻璃板	淺綠色玻璃片
黄绿色陶瓦	淺綠色陶土
黄绿色羊毛	淺綠色羊毛
磁石	磁石
织布机	紡織機
品红色旗帜	洋紅色旗幟
品红色床	洋紅色床
品红色蜡烛	洋紅色蠟燭
插上品红色蜡烛的蛋糕	插上洋紅色蠟燭的蛋糕
品红色地毯	洋紅色地毯
品红色混凝土	洋紅色混凝土
品红色混凝土粉末	洋紅色混凝土粉末
品红色带釉陶瓦	洋紅色釉陶
品红色潜影盒	洋紅色界伏盒
品红色染色玻璃	洋紅色玻璃
品红色染色玻璃板	洋紅色玻璃片
品红色陶瓦	洋紅色陶土
品红色羊毛	洋紅色羊毛
岩浆块	岩漿塊
红树木按钮	紅樹林木按鈕
红树木门	紅樹林木門
红树木栅栏	紅樹林木柵欄
红树木栅栏门	紅樹林木柵欄門
悬挂式红树木告示牌	懸掛式紅樹林木告示牌
红树树叶	紅樹林木樹葉
红树原木	紅樹林木原木
红树木板	紅樹林木材
红树木压力板	紅樹林木壓力板
红树胎生苗	紅樹林木胎生苗
红树根	紅樹林木根
红树木展示架	紅樹林木物品架
红树木告示牌	紅樹林木告示牌
红树木台阶	紅樹林木半磚
红树木楼梯	紅樹林木階梯
红树木活板门	紅樹林木地板門
墙上的悬挂式红树木告示牌	牆上的懸掛式紅樹林木告示牌
墙上的红树木告示牌	牆上的紅樹林木告示牌
红树木	紅樹林木塊
中型紫晶芽	中型紫水晶芽
西瓜	西瓜
西瓜茎	西瓜梗
苔藓块	苔蘚方塊
覆地苔藓	覆地苔蘚
苔石	青苔鵝卵石
苔石台阶	青苔鵝卵石半磚
苔石楼梯	青苔鵝卵石階梯
苔石墙	青苔鵝卵石牆
苔石砖台阶	青苔石磚半磚
苔石砖楼梯	青苔石磚階梯
苔石砖墙	青苔石磚牆
苔石砖	青苔石磚
移动的活塞	移動中的活塞
泥巴	泥巴
泥砖台阶	泥磚半磚
泥砖楼梯	泥磚階梯
泥砖墙	泥磚牆
泥砖	泥磚
沾泥的红树根	淤泥紅樹林木根
蘑菇柄	蘑菇柄
菌丝体	菌絲土
下界砖栅栏	地獄磚柵欄
下界砖台阶	地獄磚半磚
下界砖楼梯	地獄磚階梯
下界砖墙	地獄磚牆
下界砖块	地獄磚
下界金矿石	地獄金礦
下界传送门	地獄傳送門
下界石英矿石	地獄石英礦
下界苗	地獄芽
下界疣	地獄疙瘩
下界疣块	地獄疙瘩塊
下界合金块	獄髓方塊
下界岩	地獄石
音符盒	音階盒
橡木按钮	橡木按鈕
橡木门	橡木門
橡木栅栏	橡木柵欄
橡木栅栏门	橡木柵欄門
悬挂式橡木告示牌	懸掛式橡木告示牌
橡树树叶	橡木樹葉
橡木原木	橡木原木
橡木木板	橡木材
橡木压力板	橡木壓力板
橡树树苗	橡木樹苗
橡木展示架	橡木展示架
橡木告示牌	橡木告示牌
橡木台阶	橡木半磚
橡木楼梯	橡木階梯
橡木活板门	橡木地板門
墙上的悬挂式橡木告示牌	牆上的懸掛式橡木告示牌
墙上的橡木告示牌	牆上的橡木告示牌
橡木	橡木塊
侦测器	偵測器
黑曜石	黑曜石
赭黄蛙明灯	赭黃蛙光體
不祥旗帜	不祥旗幟
张开的眼眸花	張開的擬目花
橙色旗帜	橙色旗幟
橙色床	橙色床
橙色蜡烛	橙色蠟燭
插上橙色蜡烛的蛋糕	插上橙色蠟燭的蛋糕
橙色地毯	橙色地毯
橙色混凝土	橙色混凝土
橙色混凝土粉末	橙色混凝土粉末
橙色带釉陶瓦	橙色釉陶
橙色潜影盒	橙色界伏盒
橙色染色玻璃	橙色玻璃
橙色染色玻璃板	橙色玻璃片
橙色陶瓦	橙色陶土
橙色郁金香	橙色鬱金香
橙色羊毛	橙色羊毛
滨菊	雛菊
氧化的雕纹铜块	氧化的浮雕銅方塊
氧化的铜块	氧化的銅方塊
氧化的铜灯	氧化的銅燈
氧化的铜箱子	氧化的銅儲物箱
氧化的铜门	氧化的銅門
氧化的铜傀儡像	氧化的銅像
氧化的铜格栅	氧化的銅格柵
氧化的铜活板门	氧化的銅地板門
氧化的切制铜块	氧化的切製銅方塊
氧化的切制铜台阶	氧化的切製銅半磚
氧化的切制铜楼梯	氧化的切製銅階梯
氧化的避雷针	氧化的避雷針
浮冰	冰磚
泥坯	泥坯
苍白垂须	蒼白垂絲
苍白苔藓块	蒼白苔蘚方塊
苍白覆地苔藓	蒼白覆地苔蘚
苍白橡木按钮	蒼白橡木按鈕
苍白橡木门	蒼白橡木門
苍白橡木栅栏	蒼白橡木柵欄
苍白橡木栅栏门	蒼白橡木柵欄門
悬挂式苍白橡木告示牌	懸掛式蒼白橡木告示牌
苍白橡树树叶	蒼白橡木樹葉
苍白橡木原木	蒼白橡木原木
苍白橡木木板	蒼白橡木材
苍白橡木压力板	蒼白橡木壓力板
苍白橡树树苗	蒼白橡木樹苗
苍白橡木展示架	蒼白橡木物品架
苍白橡木告示牌	蒼白橡木告示牌
苍白橡木台阶	蒼白橡木半磚
苍白橡木楼梯	蒼白橡木階梯
苍白橡木活板门	蒼白橡木地板門
墙上的悬挂式苍白橡木告示牌	牆上的懸掛式蒼白橡木告示牌
墙上的苍白橡木告示牌	牆上的蒼白橡木告示牌
苍白橡木	蒼白橡木塊
珠光蛙明灯	珠紫蛙光體
牡丹	牡丹花
石化橡木台阶	石化橡木半磚
猪灵的头	豬布林頭顱
墙上的猪灵的头	牆上的豬布林頭顱
粉红色旗帜	粉紅色旗幟
粉红色床	粉紅色床
粉红色蜡烛	粉紅色蠟燭
插上粉红色蜡烛的蛋糕	插上粉紅色蠟燭的蛋糕
粉红色地毯	粉紅色地毯
粉红色混凝土	粉紅色混凝土
粉红色混凝土粉末	粉紅色混凝土粉末
粉红色带釉陶瓦	粉紅色釉陶
粉红色花簇	粉瓣花
粉红色潜影盒	粉紅色界伏盒
粉红色染色玻璃	粉紅色玻璃
粉红色染色玻璃板	粉紅色玻璃片
粉红色陶瓦	粉紅色陶土
粉红色郁金香	粉紅色鬱金香
粉红色羊毛	粉紅色羊毛
活塞	活塞
活塞头	活塞頭
瓶子草植株	瓶子草植株
瓶子草	瓶子草
玩家的头	玩家頭顱
%s的头	%s 的頭顱
墙上的玩家的头	牆上的玩家頭顱
灰化土	灰壤
滴水石锥	鐘乳石
磨制安山岩	拋光安山岩
磨制安山岩台阶	拋光安山岩半磚
磨制安山岩楼梯	拋光安山岩階梯
磨制玄武岩	拋光玄武岩
磨制黑石	拋光黑石
磨制黑石砖台阶	拋光黑石磚半磚
磨制黑石砖楼梯	拋光黑石磚階梯
磨制黑石砖墙	拋光黑石磚牆
磨制黑石砖	拋光黑石磚
磨制黑石按钮	拋光黑石按鈕
磨制黑石压力板	拋光黑石壓力板
磨制黑石台阶	拋光黑石半磚
磨制黑石楼梯	拋光黑石階梯
磨制黑石墙	拋光黑石牆
磨制深板岩	拋光深板岩
磨制深板岩台阶	拋光深板岩半磚
磨制深板岩楼梯	拋光深板岩階梯
磨制深板岩墙	拋光深板岩牆
磨制闪长岩	拋光閃長岩
磨制闪长岩台阶	拋光閃長岩半磚
磨制闪长岩楼梯	拋光閃長岩階梯
磨制花岗岩	拋光花崗岩
磨制花岗岩台阶	拋光花崗岩半磚
磨制花岗岩楼梯	拋光花崗岩階梯
磨制凝灰岩	拋光凝灰岩
磨制凝灰岩台阶	拋光凝灰岩半磚
磨制凝灰岩楼梯	拋光凝灰岩階梯
磨制凝灰岩墙	拋光凝灰岩牆
虞美人	罌粟
马铃薯	馬鈴薯
金合欢树苗盆栽	相思木樹苗盆栽
绒球葱盆栽	紫紅球花盆栽
杜鹃花丛盆栽	杜鵑叢盆栽
蓝花美耳草盆栽	雛草盆栽
竹子盆栽	竹子盆栽
白桦树苗盆栽	樺木樹苗盆栽
兰花盆栽	藍色蝴蝶蘭盆栽
棕色蘑菇盆栽	棕色蘑菇盆栽
仙人掌盆栽	仙人掌盆栽
樱花树苗盆栽	櫻花木樹苗盆栽
闭合的眼眸花盆栽	閉合的擬目花盆栽
矢车菊盆栽	矢車菊盆栽
绯红菌盆栽	緋紅蕈菇盆栽
绯红菌索盆栽	緋紅蕈根盆栽
蒲公英盆栽	蒲公英盆栽
深色橡树树苗盆栽	黑橡木樹苗盆栽
枯萎的灌木盆栽	枯灌木盆栽
蕨盆栽	蕨類盆栽
盛开的杜鹃花丛盆栽	開花的杜鵑叢盆栽
丛林树苗盆栽	叢林木樹苗盆栽
铃兰盆栽	鈴蘭盆栽
红树胎生苗盆栽	紅樹林木胎生苗盆栽
橡树树苗盆栽	橡木樹苗盆栽
张开的眼眸花盆栽	張開的擬目花盆栽
橙色郁金香盆栽	橙色鬱金香盆栽
滨菊盆栽	雛菊盆栽
苍白橡树树苗盆栽	蒼白橡木樹苗盆栽
粉红色郁金香盆栽	粉紅色鬱金香盆栽
虞美人盆栽	罌粟盆栽
红色蘑菇盆栽	紅色蘑菇盆栽
红色郁金香盆栽	紅色鬱金香盆栽
云杉树苗盆栽	杉木樹苗盆栽
火把花盆栽	火把花盆栽
诡异菌盆栽	扭曲蕈菇盆栽
诡异菌索盆栽	扭曲蕈根盆栽
白色郁金香盆栽	白色鬱金香盆栽
凋灵玫瑰盆栽	凋零玫瑰盆栽
细雪	粉雪
装有细雪的炼药锅	裝粉雪的鍋釜
动力铁轨	動力鐵軌
海晶石	海磷石
海晶石砖台阶	海磷石磚半磚
海晶石砖楼梯	海磷石磚階梯
海晶石砖	海磷石磚
海晶石台阶	海磷石半磚
海晶石楼梯	海磷石階梯
海晶石墙	海磷石牆
南瓜	南瓜
南瓜茎	南瓜梗
紫色旗帜	紫色旗幟
紫色床	紫色床
紫色蜡烛	紫色蠟燭
插上紫色蜡烛的蛋糕	插上紫色蠟燭的蛋糕
紫色地毯	紫色地毯
紫色混凝土	紫色混凝土
紫色混凝土粉末	紫色混凝土粉末
紫色带釉陶瓦	紫色釉陶
紫色潜影盒	紫色界伏盒
紫色染色玻璃	紫色玻璃
紫色染色玻璃板	紫色玻璃片
紫色陶瓦	紫色陶土
紫色羊毛	紫色羊毛
紫珀块	紫珀方塊
紫珀柱	紫珀柱
紫珀台阶	紫珀半磚
紫珀楼梯	紫珀階梯
石英块	石英方塊
石英砖	石英磚
石英柱	石英柱
石英台阶	石英半磚
石英楼梯	石英階梯
铁轨	鐵軌
粗铜块	銅原礦方塊
粗金块	金原礦方塊
粗铁块	鐵原礦方塊
红色旗帜	紅色旗幟
红色床	紅色床
红色蜡烛	紅色蠟燭
插上红色蜡烛的蛋糕	插上紅色蠟燭的蛋糕
红色地毯	紅色地毯
红色混凝土	紅色混凝土
红色混凝土粉末	紅色混凝土粉末
红色带釉陶瓦	紅色釉陶
红色蘑菇	紅色蘑菇
红色蘑菇方块	紅色蘑菇方塊
红色下界砖台阶	紅地獄磚半磚
红色下界砖楼梯	紅地獄磚階梯
红色下界砖墙	紅地獄磚牆
红色下界砖块	紅地獄磚
红沙	紅沙
红砂岩	紅砂岩
红砂岩台阶	紅砂岩半磚
红砂岩楼梯	紅砂岩階梯
红砂岩墙	紅砂岩牆
红色潜影盒	紅色界伏盒
红色染色玻璃	紅色玻璃
红色染色玻璃板	紅色玻璃片
红色陶瓦	紅色陶土
红色郁金香	紅色鬱金香
红色羊毛	紅色羊毛
红石块	紅石方塊
红石灯	紅石燈
红石矿石	紅石礦
红石火把	紅石火把
墙上的红石火把	牆上的紅石火把
红石线	紅石線
强化深板岩	強化深板岩
红石中继器	紅石中繼器
循环型命令方块	重複型指令方塊
树脂块	樹脂方塊
树脂砖台阶	樹脂磚半磚
树脂砖楼梯	樹脂磚階梯
树脂砖墙	樹脂磚牆
树脂砖块	樹脂磚
树脂团	樹脂團
重生锚	重生錨
缠根泥土	扎根土
玫瑰丛	玫瑰叢
沙子	沙
砂岩	砂岩
砂岩台阶	砂岩半磚
砂岩楼梯	砂岩階梯
砂岩墙	砂岩牆
脚手架	鷹架
幽匿块	伏聆
幽匿催发体	伏聆觸媒
幽匿感测体	伏聆振測器
幽匿尖啸体	伏聆嘯口
幽匿脉络	伏聆脈絡
海晶灯	海燈籠
海泡菜	海鞘
海草	海草
已设置重生点	已設定重生點
矮枯草丛	矮枯草
矮草丛	矮草
菌光体	蕈光體
潜影盒	界伏盒
骷髅头颅	骷髏頭顱
墙上的骷髅头颅	牆上的骷髏頭顱
黏液块	史萊姆方塊
小型紫晶芽	小型紫水晶芽
小型垂滴叶	小懸葉草
锻造台	鍛造台
烟熏炉	煙燻爐
平滑玄武岩	平滑玄武岩
平滑石英块	平滑石英方塊
平滑石英台阶	平滑石英半磚
平滑石英楼梯	平滑石英階梯
平滑红砂岩	平滑紅砂岩
平滑红砂岩台阶	平滑紅砂岩半磚
平滑红砂岩楼梯	平滑紅砂岩階梯
平滑砂岩	平滑砂岩
平滑砂岩台阶	平滑砂岩半磚
平滑砂岩楼梯	平滑砂岩階梯
平滑石头	平滑石頭
平滑石头台阶	平滑石半磚
嗅探兽蛋	嗅探獸蛋
雪	雪
雪块	雪塊
灵魂营火	靈魂營火
灵魂火	靈魂火
灵魂灯笼	靈魂燈籠
灵魂沙	靈魂砂
灵魂土	靈魂土
灵魂火把	靈魂火把
墙上的灵魂火把	牆上的靈魂火把
你的床或已充能的重生锚不存在或已被阻挡	你沒有床或已充能的重生錨，或是它受到阻擋
刷怪笼	生怪磚
用刷怪蛋交互时：	用生怪蛋互動時：
设置生物种类	設定生物種類
海绵	海綿
孢子花	孢子花
云杉木按钮	杉木按鈕
云杉木门	杉木門
云杉木栅栏	杉木柵欄
云杉木栅栏门	杉木柵欄門
悬挂式云杉木告示牌	懸掛式杉木告示牌
云杉树叶	杉木樹葉
云杉原木	杉木原木
云杉木板	杉木材
云杉木压力板	杉木壓力板
云杉树苗	杉木樹苗
云杉木展示架	杉木物品架
云杉木告示牌	杉木告示牌
云杉木台阶	杉木半磚
云杉木楼梯	杉木階梯
云杉木活板门	杉木地板門
墙上的悬挂式云杉木告示牌	牆上的懸掛式杉木告示牌
墙上的云杉木告示牌	牆上的杉木告示牌
云杉木	杉木塊
黏性活塞	黏性活塞
石头	石頭
石砖台阶	石磚半磚
石砖楼梯	石磚階梯
石砖墙	石磚牆
石砖	石磚
石头按钮	石製按鈕
石头压力板	石製壓力板
石头台阶	石半磚
石头楼梯	石頭階梯
切石机	切石機
去皮金合欢原木	剝皮相思木原木
去皮金合欢木	剝皮相思木塊
去皮竹块	剝皮竹方塊
去皮白桦原木	剝皮樺木原木
去皮白桦木	剝皮樺木塊
去皮樱花原木	剝皮櫻花木原木
去皮樱花木	剝皮櫻花木塊
去皮绯红菌核	剝皮緋紅菌絲體
去皮绯红菌柄	剝皮緋紅蕈柄
去皮深色橡木原木	剝皮黑橡木原木
去皮深色橡木	剝皮黑橡木塊
去皮丛林原木	剝皮叢林木原木
去皮丛林木	剝皮叢林木塊
去皮红树原木	剝皮紅樹林木原木
去皮红树木	剝皮紅樹林木塊
去皮橡木原木	剝皮橡木原木
去皮橡木	剝皮橡木塊
去皮苍白橡木原木	剝皮蒼白橡木原木
去皮苍白橡木	剝皮蒼白橡木塊
去皮云杉原木	剝皮杉木原木
去皮云杉木	剝皮杉木塊
去皮诡异菌核	剝皮扭曲菌絲體
去皮诡异菌柄	剝皮扭曲蕈柄
结构方块	結構方塊
结构空位	結構空位
甘蔗	甘蔗
向日葵	向日葵
可疑的沙砾	可疑的礫石
可疑的沙子	可疑的沙
甜浆果丛	甜莓灌木叢
高枯草丛	高枯草
高草丛	芒草
高海草	高海草
标靶	標靶
陶瓦	陶土
测试方块	測試方塊
测试实例方块	測試實例方塊
遮光玻璃	遮光玻璃
TNT	TNT
TNT爆炸已禁用	TNT 爆炸已停用
火把	火把
火把花	火把花
火把花植株	火把花植株
陷阱箱	陷阱儲物箱
试炼刷怪笼	試煉生怪磚
绊线	絆線
绊线钩	絆線鉤
管珊瑚	管珊瑚
管珊瑚块	管珊瑚方塊
管珊瑚扇	扇狀管珊瑚
墙上的管珊瑚扇	牆上的扇狀管珊瑚
凝灰岩	凝灰岩
凝灰岩砖台阶	凝灰岩磚半磚
凝灰岩砖楼梯	凝灰岩磚階梯
凝灰岩砖墙	凝灰岩磚牆
凝灰岩砖	凝灰岩磚
凝灰岩台阶	凝灰岩半磚
凝灰岩楼梯	凝灰岩階梯
凝灰岩墙	凝灰岩牆
海龟蛋	海龜蛋
缠怨藤	扭曲藤
缠怨藤植株	扭曲藤植株
宝库	寶庫
青翠蛙明灯	蒼翠蛙光體
藤蔓	藤蔓
虚空空气	虛空空氣
墙上的火把	牆上的火把
诡异木按钮	扭曲蕈木按鈕
诡异木门	扭曲蕈木門
诡异木栅栏	扭曲蕈木柵欄
诡异木栅栏门	扭曲蕈木柵欄門
诡异菌	扭曲蕈菇
悬挂式诡异木告示牌	懸掛式扭曲蕈木告示牌
诡异菌核	扭曲菌絲體
诡异菌岩	扭曲菌絲石
诡异木板	扭曲蕈木材
诡异木压力板	扭曲蕈木壓力板
诡异菌索	扭曲蕈根
诡异木展示架	扭曲蕈木物品架
诡异木告示牌	扭曲蕈木告示牌
诡异木台阶	扭曲蕈木半磚
诡异木楼梯	扭曲蕈木階梯
诡异菌柄	扭曲蕈柄
诡异木活板门	扭曲蕈木地板門
墙上的悬挂式诡异木告示牌	牆上的懸掛式扭曲蕈木告示牌
墙上的诡异木告示牌	牆上的扭曲蕈木告示牌
诡异疣块	扭曲疙瘩塊
水	水
装有水的炼药锅	裝水的鍋釜
涂蜡的雕纹铜块	上蠟的浮雕銅方塊
涂蜡的铜块	上蠟的銅方塊
涂蜡的铜灯	上蠟的銅燈
涂蜡的铜箱子	上蠟的銅儲物箱
涂蜡的铜门	上蠟的銅門
涂蜡的铜傀儡像	上蠟的銅像
涂蜡的铜格栅	上蠟的銅格柵
涂蜡的铜活板门	上蠟的銅地板門
涂蜡的切制铜块	上蠟的切製銅方塊
涂蜡的切制铜台阶	上蠟的切製銅半磚
涂蜡的切制铜楼梯	上蠟的切製銅階梯
涂蜡的斑驳雕纹铜块	上蠟的斑駁浮雕銅方塊
涂蜡的斑驳铜块	上蠟的斑駁銅方塊
涂蜡的斑驳铜灯	上蠟的斑駁銅燈
涂蜡的斑驳铜箱子	上蠟的斑駁銅儲物箱
涂蜡的斑驳铜门	上蠟的斑駁銅門
涂蜡的斑驳铜傀儡像	上蠟的斑駁銅像
涂蜡的斑驳铜格栅	上蠟的斑駁銅格柵
涂蜡的斑驳铜活板门	上蠟的斑駁銅地板門
涂蜡的斑驳切制铜块	上蠟的斑駁切製銅方塊
涂蜡的斑驳切制铜台阶	上蠟的斑駁切製銅半磚
涂蜡的斑驳切制铜楼梯	上蠟的斑駁切製銅階梯
涂蜡的斑驳避雷针	上蠟的斑駁避雷針
涂蜡的避雷针	上蠟的避雷針
涂蜡的氧化雕纹铜块	上蠟的氧化浮雕銅方塊
涂蜡的氧化铜块	上蠟的氧化銅方塊
涂蜡的氧化铜灯	上蠟的氧化銅燈
涂蜡的氧化铜箱子	上蠟的氧化銅儲物箱
涂蜡的氧化铜门	上蠟的氧化銅門
涂蜡的氧化铜傀儡像	上蠟的氧化銅像
涂蜡的氧化铜格栅	上蠟的氧化銅格柵
涂蜡的氧化铜活板门	上蠟的氧化銅地板門
涂蜡的氧化切制铜块	上蠟的氧化切製銅方塊
涂蜡的氧化切制铜台阶	上蠟的氧化切製銅半磚
涂蜡的氧化切制铜楼梯	上蠟的氧化切製銅階梯
涂蜡的氧化避雷针	上蠟的氧化避雷針
涂蜡的锈蚀雕纹铜块	上蠟的風化浮雕銅方塊
涂蜡的锈蚀铜块	上蠟的風化銅方塊
涂蜡的锈蚀铜灯	上蠟的風化銅燈
涂蜡的锈蚀铜箱子	上蠟的風化銅儲物箱
涂蜡的锈蚀铜门	上蠟的風化銅門
涂蜡的锈蚀铜傀儡像	上蠟的風化銅像
涂蜡的锈蚀铜格栅	上蠟的風化銅格柵
涂蜡的锈蚀铜活板门	上蠟的風化銅地板門
涂蜡的锈蚀切制铜块	上蠟的風化切製銅方塊
涂蜡的锈蚀切制铜台阶	上蠟的風化切製銅半磚
涂蜡的锈蚀切制铜楼梯	上蠟的風化切製銅階梯
涂蜡的锈蚀避雷针	上蠟的風化避雷針
锈蚀的雕纹铜块	風化的浮雕銅方塊
锈蚀的铜块	風化的銅方塊
锈蚀的铜灯	風化的銅燈
锈蚀的铜箱子	風化的銅儲物箱
锈蚀的铜门	風化的銅門
锈蚀的铜傀儡像	風化的銅魔像雕像
锈蚀的铜格栅	風化的銅格柵
锈蚀的铜活板门	風化的銅地板門
锈蚀的切制铜块	風化的切製銅方塊
锈蚀的切制铜台阶	風化的切製銅半磚
锈蚀的切制铜楼梯	風化的切製銅階梯
锈蚀的避雷针	風化的避雷針
垂泪藤	垂泣藤
垂泪藤植株	垂泣藤植株
湿海绵	濕海綿
小麦植株	小麥植株
白色旗帜	白色旗幟
白色床	白色床
白色蜡烛	白色蠟燭
插上白色蜡烛的蛋糕	插上白色蠟燭的蛋糕
白色地毯	白色地毯
白色混凝土	白色混凝土
白色混凝土粉末	白色混凝土粉末
白色带釉陶瓦	白色釉陶
白色潜影盒	白色界伏盒
白色染色玻璃	白色玻璃
白色染色玻璃板	白色玻璃片
白色陶瓦	白色陶土
白色郁金香	白色鬱金香
白色羊毛	白色羊毛
野花簇	野花簇
凋灵玫瑰	凋零玫瑰
凋灵骷髅头颅	凋零骷髏頭顱
墙上的凋灵骷髅头颅	牆上的凋零骷髏頭顱
黄色旗帜	黃色旗幟
黄色床	黃色床
黄色蜡烛	黃色蠟燭
插上黄色蜡烛的蛋糕	插上黃色蠟燭的蛋糕
黄色地毯	黃色地毯
黄色混凝土	黃色混凝土
黄色混凝土粉末	黃色混凝土粉末
黄色带釉陶瓦	黃色釉陶
黄色潜影盒	黃色界伏盒
黄色染色玻璃	黃色玻璃
黄色染色玻璃板	黃色玻璃片
黄色陶瓦	黃色陶土
黄色羊毛	黃色羊毛
僵尸的头	殭屍頭顱
墙上的僵尸的头	牆上的殭屍頭顱
%1$s 著	作者 %1$s
书本编辑屏幕	書本編輯畫面
输入书名：	輸入書名：
署名并关闭	署名並完成
注意！在你署名后，它将不能再被修改。	注意！當您在這本書署名後，將無法再修改書中內容。
原稿	原始版本
原稿的副本	複本
副本的副本	複本的複本
破烂不堪	破舊的
* 无效的书本标签 *	* 書本標籤無效 *
第%1$s页/共%2$s页	第 %1$s 頁/共 %2$s 頁
下一页	下一頁
上一页	上一頁
书本署名屏幕	書本署名畫面
标题	標題
署名	署名
书本浏览屏幕	書本檢視畫面
建筑高度限制是%s	最大建築高度限制為 %s
无法发送聊天消息	無法傳送聊天訊息
%s, %s, %s	%s, %s, %s
点此传送	按此傳送
复制到剪贴板	複製到剪貼簿
单击复制到剪贴板	按此複製到剪貼簿
此聊天消息已被服务器删除。	這則訊息已被伺服器刪除。
由于消息链损坏，聊天已被禁用。请尝试重新连接。	由於訊息鏈中斷，聊天已被停用。請嘗試重新連線。
由于个人信息公钥过期，聊天已被禁用。请尝试重新连接。	由於個人資訊公鑰過期，已停用聊天功能。請嘗試重新連線。
命令包含意外或缺失的命令参数签名。	指令包含非預期的或是遺漏的指令引數簽章。
聊天签名无效。请尝试重新连接。	聊天簽章無效。請嘗試重新連線。
聊天在启动器选项中被禁用。无法发送消息。	啟動器選項已停用聊天功能。無法傳送訊息。
由于个人信息公钥丢失，聊天已被禁用。请尝试重新连接。	由於個人資訊公鑰遺失，已停用聊天功能。請嘗試重新連線。
聊天在客户端选项中被禁用。	用戶端選項已停用聊天功能。
接收到了乱序的聊天消息。你的系统时间是否被更改过？	收到的聊天訊息順序不正確。您的系統時間是否已變更？
聊天在账户设置中被禁用。再按一次“%s”以获取更多信息。	聊天功能受到帳號設定限制。請重新按下「%s」以取得更多資訊。
聊天在账户设置中被禁用。无法发送或查看消息。	聊天功能受到帳號設定限制。無法傳送或查看訊息。
聊天	聊天欄
被服务器过滤。	被伺服器過濾。
服务器已向部分玩家隐藏了你的消息。	伺服器已為部分玩家隱藏您的訊息。
你确定要打开以下网页？	你確定要開啟以下網頁嗎？
你想要打开这个链接或将其复制到你的剪贴板吗？	確定要開啟此連結或將它複製到剪貼簿嗎？
在浏览器中打开	在瀏覽器中開啟
永远不要打开你不信任的人提供的链接！	千萬不要開啟任何你不信任的人所提供的連結！
[+%s行待发送]	[+%s 則待傳送訊息]
[%s]	[%s]
服务器发送了无效消息。	伺服器傳送了無效訊息。
消息被服务器修改。原文：	訊息被伺服器修改過。原文：
未经验证的消息。无法举报。	無法檢舉未認證的訊息。
服务器消息。无法举报。	無法檢舉伺服器訊息。
服务器消息。	伺服器訊息。
[%s: %s]	[%s: %s]
%s完成了挑战%s	%s 已完成挑戰 %s
%s达成了目标%s	%s 已達成目標 %s
%s取得了进度%s	%s 已完成進度 %s
[%s] %s	[%s] %s
* %s %s	* %s %s
发送队伍消息	傳送隊伍訊息
-> %s <%s> %s	-> %s <%s> %s
%s <%s> %s	%s <%s> %s
<%s> %s	<%s> %s
%s说%s	%s 說︰%s
聊天验证错误	聊天驗證錯誤
要发送的消息：%s	傳送訊息：%s
聊天屏幕	聊天畫面
输入消息并按Enter键发送	輸入訊息後按下 Enter 鍵傳送
查看日志获取详情	查看記錄檔以取得詳細資訊
无法加载%s处的区块	無法載入 %s 處的區塊
磁盘空间不足！	磁碟空間不足！
可能无法保存世界。	可能無法儲存世界。
无法保存%s处的区块	無法儲存 %s 處的區塊
未能从%s名玩家找到任何物品	在 %s 個玩家身上找不到任何物品
未能从玩家%s找到任何物品	在玩家 %s 身上找不到任何物品
黑色	黑色
蓝色	藍色
棕色	棕色
青色	青色
灰色	灰色
绿色	綠色
淡蓝色	淺藍色
淡灰色	淺灰色
黄绿色	淺綠色
品红色	洋紅色
橙色	橙色
粉红色	粉紅色
紫色	紫色
红色	紅色
白色	白色
黄色	黃色
<--[此处]	<--［這裡］
%s，位于第%s个字符：%s	第 %2$s 個字元 %1$s：%3$s
无法解析命令：%s	無法解析指令：%s
参数后应有空格分隔，但发现了紧邻的数据	引數結尾應為空白字元，但發現有尾隨資料
试图执行该命令时出现意外错误	試圖執行該指令時發生了非預期性錯誤
上下文数量已达上限值（%s）	已達上下文數量上限 (%s)
错误的命令参数	指令的引數不正確
未知或不完整的命令，错误见下	未知或不完整的指令，錯誤如下
进度%1$s并不包含条件“%2$s”	進度 %1$s 不包含 '%2$s' 標準條件
无法将进度%2$s的达成条件“%1$s”赋予%3$s名玩家，因为他们已达成此条件	無法將進度 %2$s 的條件 '%1$s' 給予 %3$s 個玩家，因為他們已經擁有該條件
已将进度%2$s的达成条件“%1$s”赋予%3$s名玩家	已將進度 %2$s 的條件 '%1$s' 給予 %3$s 個玩家
无法将进度%2$s的达成条件“%1$s”赋予%3$s，因为该玩家已达成此条件	無法將進度 %2$s 的條件 '%1$s' 給予 %3$s，因為他已經擁有該條件
已将进度%2$s的达成条件“%1$s”赋予%3$s	已將進度 %2$s 的條件 '%1$s' 給予 %3$s
无法将%s项进度赋予%s名玩家，因为他们已达成这些进度	無法將 %s 個進度給予 %s 個玩家，因為他們已達成那些進度
已将%s项进度赋予%s名玩家	已將 %s 個進度給予 %s 個玩家
无法将%s项进度赋予%s，因为该玩家已达成这些进度	無法將 %s 個進度給予 %s，因為他已達成此進度
已将%s项进度赋予%s	已將 %s 個進度給予 %s
无法将进度%s赋予%s名玩家，因为他们已达成此进度	無法將進度 %s 給予 %s 個玩家，因為他們已達成此進度
已将进度%s赋予%s名玩家	已將進度 %s 給予 %s 個玩家
无法将进度%s赋予%s，因为该玩家已达成此进度	無法將進度 %s 給予 %s，因為他已達成此進度
已将进度%s赋予%s	已將進度 %s 給予 %s
无法撤销%3$s名玩家关于进度%2$s的达成条件“%1$s”，因为他们并未达成此条件	無法從 %3$s 個玩家身上撤銷進度 %2$s 尚未取得的的條件 '%1$s'
已撤销%3$s名玩家关于进度%2$s的达成条件“%1$s”	已從 %3$s 個玩家身上撤銷進度 %2$s 的條件 '%1$s'
无法撤销%3$s关于进度%2$s的达成条件“%1$s”，因为该玩家并未达成此条件	無法從 %3$s 身上撤銷進度 %2$s 尚未取得的條件 '%1$s'
已撤销%3$s关于进度%2$s的达成条件“%1$s”	已從 %3$s 身上撤銷進度 %2$s 的條件 '%1$s'
无法撤销%2$s名玩家的%1$s项进度，因为他们并未达成此进度	無法從 %2$s 個玩家身上撤銷尚未取得的 %1$s 個進度
已撤销%2$s名玩家的%1$s项进度	已從 %2$s 個玩家身上撤銷 %1$s 個進度
无法撤销%2$s的%1$s项进度，因为该玩家并未达成这些进度	無法從 %2$s 身上撤銷尚未取得的 %1$s 個進度
已撤销%2$s的%1$s项进度	已從 %2$s 身上撤銷 %1$s 個進度
无法撤销%2$s名玩家的进度%1$s，因为他们并未达成此进度	無法從 %2$s 個玩家身上撤銷尚未取得的進度 %1$s
已撤销%2$s名玩家的进度%1$s	已從 %2$s 個玩家身上撤銷進度 %1$s
无法撤销%2$s的进度%1$s，因为该玩家并未达成此进度	無法從 %2$s 身上撤銷尚未取得的進度 %1$s
已撤销%2$s的进度%1$s	已從 %2$s 身上撤銷進度 %1$s
实体%2$s的属性%1$s的基值为%3$s	實體 %2$s 的屬性 %1$s 基礎值為 %3$s
实体%2$s的属性%1$s的基值已重置为默认值%3$s	已將實體 %2$s 的屬性 %1$s 重設為預設值 %3$s
实体%2$s的属性%1$s的基值已设置为%3$s	已將實體 %2$s 的屬性 %1$s 基礎值設定為 %3$s
%s不是此命令的有效实体	%s 不是這條指令的有效實體
实体%3$s的属性%2$s已存在修饰符%1$s	實體 %3$s 於屬性 %2$s 中已存在修飾符 %1$s
实体%s没有属性%s	實體 %s 沒有屬性 %s
实体%2$s的属性%1$s无修饰符%3$s	實體 %2$s 的屬性 %1$s 沒有修飾符 %3$s
为实体%3$s的属性%2$s添加了修饰符%1$s	已為實體 %3$s 的屬性 %2$s 加上修飾符 %1$s
为实体%3$s的属性%2$s移除了修饰符%1$s	已從實體 %3$s 的屬性 %2$s 移除修飾符 %1$s
实体%3$s的属性%2$s中修饰符%1$s值为%4$s	實體 %3$s 於屬性 %2$s 上的修飾符 %1$s 值為 %4$s
实体%2$s的属性%1$s的值为%3$s	實體 %2$s 的屬性 %1$s 值為 %3$s
无变化，该玩家已被封禁	未進行任何變更。該玩家已經被封鎖了
已封禁%s：%s	%s 已被封鎖：%s
无变化，该IP地址已被封禁	未進行任何變更。這個 IP 已被封鎖
此次封禁涉及%s名玩家：%s	這次封鎖作用於 %s 個玩家：%s
无效的IP地址或未知的玩家	無效的 IP 位址或未知的玩家
已封禁IP地址%s：%s	已封鎖 IP %s: %s
%s被%s封禁：%s	%s 被 %s 封鎖：%s
（未知）	（未知）
共有%s条封禁：	以下 %s 個玩家被封鎖：
没有玩家被封禁	沒有被封鎖的玩家
ID为“%s”的Boss栏已经存在	已存在 ID 為 '%s' 的 Boss 狀態條
已创建自定义Boss栏%s	已建立自訂 Boss 狀態條 %s
自定义Boss栏%s的最大值为%s	自訂 Boss 狀態條 %s 的最大值為 %s
自定义Boss栏%s目前没有在线玩家	自訂 Boss 狀態條 %s 目前沒有在線上的玩家
自定义Boss栏%s当前在线的%s名玩家有：%s	自訂 Boss 狀態條 %s 目前有 %s 位玩家在線上：%s
自定义Boss栏%s的数值为%s	自訂 Boss 狀態條 %s 的數值為 %s
自定义Boss栏%s现为隐藏	自訂 Boss 狀態條 %s 目前為隱藏
自定义Boss栏%s现为可见	自訂 Boss 狀態條 %s 目前可見
无运行中的自定义Boss栏	沒有已啟用的自訂 Boss 狀態條
有%s项运行中的自定义Boss栏：%s	已啟用的 %s 個自訂 Boss 狀態條為：%s
已移除自定义Boss栏%s	已移除自訂 Boss 狀態條 %s
已更改自定义Boss栏%s的颜色	已變更自訂 Boss 狀態條 %s 的顏色
无变化，这本就是这个Boss栏的颜色	未進行任何變更。此 Boss 狀態條已經是該顏色
自定义Boss栏%s的最大值已改为%s	已將自訂 Boss 狀態條 %s 的最大值變更為 %s
无变化，这本就是这个Boss栏的最大值	未進行任何變更。此 Boss 狀態條已經是該最大值
已重命名自定义Boss栏%s	已重新命名自訂 Boss 狀態條 %s
无变化，这本就是这个Boss栏的名称	未進行任何變更。此 Boss 狀態條已經是該名稱
自定义Boss栏%s在当下没有在线玩家	自訂 Boss 狀態條 %s 上不再有任何玩家
自定义Boss栏%s在当下在线的%s名玩家有：%s	自訂 Boss 狀態條 %s 現在有 %s 位玩家：%s
无变化，这些玩家已经在Boss栏上，没有玩家需要被添加或移除	未進行任何變更。這些玩家已經在此 Boss 狀態條中，無法加入或移除
已改变自定义Boss栏%s的样式	已變更自訂 Boss 狀態條 %s 的樣式
无变化，这本就是这个Boss栏的样式	未進行任何變更。此 Boss 狀態條已經是該樣式
自定义Boss栏%s的值已改为%s	已將自訂 Boss 狀態條 %s 的數值更改為 %s
无变化，这本就是这个Boss栏的值	未進行任何變更。此 Boss 狀態條已經是該數值
无变化，该Boss栏原已隐藏	未進行任何變更。此 Boss 狀態條已被隱藏
无变化，该Boss栏原已可见	未進行任何變更。此 Boss 狀態條已設為可見
已将自定义Boss栏%s改为隐藏	已將自訂 Boss 狀態條 %s 設為隱藏
已将自定义Boss栏%s改为可见	已將自訂 Boss 狀態條 %s 設為可見
不存在ID为“%s”的Boss栏	ID 為 '%s' 的 Boss 狀態條不存在
已移除%2$s名玩家的%1$s个物品	已移除 %2$s 個玩家的 %1$s 個物品
已移除玩家%2$s的%1$s个物品	已移除玩家 %2$s 的 %1$s 個物品
已在%2$s名玩家身上找到%1$s个匹配的物品	在 %2$s 個玩家身上找到 %1$s 個相符的物品
已在玩家%2$s身上找到%1$s个匹配的物品	在玩家 %2$s 身上找到 %1$s 個相符的物品
未复制任何方块	未複製任何方塊
源区域和目标区域不能重叠	來源與目的區域不可重疊
已成功复制%s个方块	已成功複製 %s 個方塊
指定区域内的方块太多（最大值为%s，指定值为%s）	指定區域內的方塊太多（指定 %2$s 但最大值為 %1$s）
对象免疫指定的伤害类型	目標對指定的傷害類型免疫
已将%s伤害施加于%s	已將 %s 傷害套用至 %s
位于%2$s, %3$s, %4$s的方块的%1$s乘以%5$s倍率后的值为%6$s	位於 %2$s, %3$s, %4$s 方塊上的 %1$s 乘上 %5$s 的倍率後為 %6$s
目标方块不是方块实体	指定的方塊並非方塊實體
已修改%s, %s, %s处的方块数据	已修改位於 %s, %s, %s 的方塊資料
%s, %s, %s拥有以下方块数据：%s	%s, %s, %s 擁有以下方塊資料：%s
%2$s的%1$s在乘以倍率%3$s后的值是%4$s	%2$s 上的 %1$s 乘上 %3$s 的倍率後為 %4$s
无法修改玩家数据	無法修改玩家資料
已修改%s的实体数据	已修改 %s 的實體資料
%s拥有以下实体数据：%s	%s 擁有以下實體資料：%s
无法获取%s，只接受数字标签	無法取得 %s，只允許數字類型標籤
该参数只接受单个NBT值	此引數接受單一的 NBT 數值
无法获取%s，标签不存在	無法取得 %s，標籤不存在
无变化，所指定的属性已有这些值	未進行任何變更。指定的屬性已經是該值
应为列表，实际为：%s	應為串列，當前值：%s
应为对象，实际为：%s	應為物件，當前值：%s
应为值，实际为：%s	應為值，當前值：%s
无效的列表索引：%s	無效的串列索引：%s
无效的子串索引：%s到%s	無效的子字串索引：%s 至 %s
在存储%2$s中的%1$s在乘以倍率%3$s后的值是%4$s	儲存於 %2$s 中的 %1$s 乘上 %3$s 的倍率後為 %4$s
已修改存储%s	已修改容器 %s
存储%s含有以下内容：%s	容器 %s 擁有下列內容物：%s
名为“%s”的包已经存在	名為 '%s' 的資料包已經存在
无效的新包名“%s”	無效的新資料包名稱 '%s'
新包名“%s”中包含无效字符	新資料包名稱 '%s' 中含有無效字元
无法创建名称为“%s”的包，请检查日志	無法建立名為 '%s' 的資料包，請查看記錄檔
无法编码名称为“%s”的包的元数据：%s	無法編碼資料包 '%s' 的中繼資料：%s
已创建名为“%s”的空包	已建立名為 '%s' 的空資料包
数据包“%s”并未启用！	資料包 '%s' 未啟用！
无法禁用数据包“%s”，因为它属于已启用功能！	無法停用資料包 '%s'，因為它屬於已啟用的功能！
数据包“%s”已经启用！	資料包 '%s' 已經啟用！
无法启用数据包“%s”，因为所需的功能未在此世界启用：%s！	無法啟用資料包 '%s'，因為所需的功能並未在這個世界中啟用：%s！
已无更多可用的数据包	沒有可用的資料包
共有%s个数据包可用：%s	有 %s 個可用的資料包： %s
没有启用中的数据包	沒有啟用的資料包
已启用%s个数据包：%s	有 %s 個啟用的資料包：%s
正在禁用数据包%s	正在停用資料包 %s
正在启用数据包%s	正在啟用資料包 %s
未知的数据包 “%s”	未知的資料包 '%s'
刻分析器原已开启	刻點分析器已在執行中
无法从函数内部开始追踪	無法從函數內部開始追蹤
使用/return run时无法追踪	追蹤無法與 /return run 同時使用
已追踪%2$s个函数内的%1$s条命令至输出文件%3$s	從 %2$s 個函數追蹤到的 %1$s 個指令輸出至檔案 %3$s
已追踪函数“%2$s”内的%1$s条命令至输出文件%3$s	已從函數 '%2$s' 追蹤到的 %1$s 個指令輸出至檔案 %3$s
追踪函数失败	函數追蹤失敗
尚未启动刻分析器	刻點分析器未啟動
已开始刻分析	開始刻點分析
已停止刻分析，用时%s秒和%s刻（每秒%s刻）	已停止刻點分析，共耗時 %s 秒和 %s 刻（每秒 %s 刻）
默认游戏模式现在为%s	這個世界的預設遊戲模式目前為 %s
无变化，此玩家不是管理员	未進行任何變更。該玩家不是管理員
%s不再是服务器管理员了	已將 %s 從伺服器管理員中除名
已清除%s名玩家的对话框	已清除 %s 個玩家的對話框
已清除%s的对话框	已清除 %s 的對話框
已将对话框展示给%s名玩家	已將對話框顯示給 %s 個玩家
已将对话框展示给%s	已將對話框顯示給 %s
难度未变，它原来就是%s	難度沒有改變，它已經被設為 %s
目前难度为%s	目前難易度為 %s
难度已被设置为%s	已將難易度設為 %s
该实体无法持有任何物品	該實體無法持有任何物品
实体%s没有战利品表	實體 %s 沒有戰利品表
方块%s没有战利品表	方塊 %s 沒有戰利品表
掉落了%s个物品	掉落 %s 個物品
从战利品表%2$s中掉落了%1$s个物品	從戰利品表 %2$s 中掉落 %1$s 個物品
掉落了%s个%s	掉落了 %s 個 %s
从战利品表%3$s中掉落了%1$s个%2$s	從戰利品表 %3$s 中掉落了 %1$s 個 %2$s
对象没有可以移除的效果	該對象沒有可以移除的效果
已移除%s个对象的所有效果	已移除 %s 個對象上的所有效果
已移除%s的所有效果	已移除 %s 身上的所有效果
对象没有指定效果	該對象沒有你指定的效果
已移除%2$s个对象的%1$s效果	已移除 %2$s 個對象身上的 %1$s 效果
已移除%2$s的%1$s效果	已移除 %2$s 身上的 %1$s 效果
无法应用此效果（对象对效果免疫，或已有更强的效果）	無法套用這項效果（該對象不受效果影響，或已有其他更強的效果）
已将%s效果应用于%s个对象	已將 %s 效果作用於 %s 個對象
已将%s效果应用于%s	已將 %s 效果作用於 %s
无变化，对象未持有物品或其不支持此魔咒	未進行任何變更。對象手中沒有物品或是無法套用這項附魔
%s不支持此魔咒	該附魔不適用於 %s
%s未手持任何物品	%s 手上沒有任何物品
%s高于该魔咒支持的最高等级%s	%s 高於該附魔所支援的最高等級 %s
已将%s魔咒应用于%s个实体	已將附魔 %s 套用於 %s 個實體
已将%s魔咒应用于%s的物品上	已將附魔 %s 套用於 %s 的物品
测试失败	測試失敗
测试失败，计数：%s	測試失敗，總計：%s
测试通过	測試通過
测试通过，计数：%s	測試通過，總計：%s
无法实例化函数%s：%s	無法具現化函數 %s：%s
已给予%2$s名玩家%1$s级经验	已給予 %2$s 個玩家 %1$s 等經驗等級
已给予%2$s %1$s级经验	已給予 %2$s %1$s 等經驗等級
已给予%2$s名玩家%1$s点经验	已給予 %2$s 個玩家 %1$s 點經驗值
已给予%2$s %1$s点经验	已給予 %2$s %1$s 點經驗值
%s拥有%s级经验	%s 擁有 %s 經驗等級
%s拥有%s点经验	%s 擁有 %s 經驗點
已将%2$s名玩家的经验等级设为%1$s	已將 %2$s 個玩家的經驗等級設定為 %1$s 等
已将%2$s的经验等级设为%1$s	已將 %2$s 的經驗等級設定為 %1$s 等
无法将此玩家的经验值设置为超过现有等级的最大值	無法將經驗點設為高於玩家目前等級的最高經驗點
已将%2$s名玩家的经验值设为%1$s	已將 %2$s 個玩家的經驗值設定為 %1$s
已将%2$s的经验值设为%1$s	已將 %2$s 的經驗值設定為 %1$s
没有方块被填充	未填滿任何方塊
已成功填充%s个方块	已成功填充 %s 個方塊
已在%s, %s, %s与%s, %s, %s之间设置生物群系	已設定自 %s, %s, %s 至 %s, %s, %s 之間的生態域
已在%2$s, %3$s, %4$s与%5$s, %6$s, %7$s之间设置%1$s个生物群系单元	已設定自 %2$s, %3$s, %4$s 至 %5$s, %6$s, %7$s 之間的 %1$s 個生態域單元
指定范围内的方块过多（最大值为%s，指定值为%s）	指定區域內的方塊太多（指定 %2$s 但最大值為 %1$s）
没有被标记为强制加载的区块	沒有區塊被標記為常駐區塊
已将%2$s中的%3$s至%4$s间的%1$s个区块标记为强制加载	已將 %2$s 中 %3$s 到 %4$s 之間的 %1$s 個區塊標記為常駐區塊
在%s中未找到强制加载的区块	從 %s 中未找到常駐區塊
已将%2$s中的区块%1$s标记为强制加载	已將 %2$s 中的區塊 %1$s 標記為常駐區塊
在%2$s内找到%1$s个强制加载的区块：%3$s	從 %2$s 中找到 %1$s 個常駐區塊：%3$s
在%s内找到一个强制加载的区块：%s	從 %s 中找到一個常駐區塊：%s
在%2$s中%1$s内的区块未被标记为强制加载	%2$s 中的區塊 %1$s 未標記為常駐區塊
在%2$s中%1$s内的区块被标记为强制加载	%2$s 中的區塊 %1$s 已標記為常駐區塊
已解除标记%s内所有的强制加载区块	已取消 %s 中的所有常駐區塊標記
没有强制加载的区块被移除	沒有移除任何常駐區塊標記
已将%2$s中的%3$s至%4$s间的%1$s个区块取消强制加载	已將 %2$s 中 %3$s 到 %4$s 之間的 %1$s 個區塊取消常駐區塊標記
已将%2$s中的区块%1$s解除强制加载	已將 %2$s 中的區塊 %1$s 取消常駐區塊標記
指定区域内区块过多（最大值为%s，指定值为%s）	指定區域內的區塊太多（最大值為 %s，指定為 %s）
无效的参数类型：%s，应为Compound类型	無效的引數類型：%s，應為 Compound
函数%1$s缺少传入参数%2$s	函數 %1$s 缺少引數 %2$s
函数%s缺少传入参数	函數 %s 缺少引數
实例化宏%s时：命令“%s”发生错误：%s	在具現化巨集 %s 時：指令 '%s' 導致錯誤：%s
函数%s返回了%s	函數 %s 已回傳 %s
正在运行函数%s	正在執行 %s 函數
无法找到名称为%s的函数	找不到名為 %s 的函數
已执行%2$s个函数中的%1$s条命令	已從 %2$s 個函數執行 %1$s 個指令
执行了%s个函数	已執行 %s 個函數
已执行函数%2$s中的%1$s条命令	已從函數 '%2$s' 執行 %1$s 個指令
函数“%2$s”返回了%1$s	函數 '%2$s' 已回傳 %1$s
已将%s的游戏模式改为%s	已將 %s 的遊戲模式切換為 %s
已将自己的游戏模式设置为%s	已將自己的遊戲模式切換為 %s
游戏规则%s目前为：%s	遊戲規則 %s 目前設為：%s
游戏规则%s已被设为：%s	遊戲規則 %s 現在已設為：%s
最多只能给予%s个%s	無法給予超過 %s 個 %s
已将%s个%s给予%s名玩家	已將 %s 個 %s 給予 %s 個玩家
已将%s个%s给予%s	已將 %s 個 %s 給予 %s
未知的命令或权限不足	未知的指令或權限不足
已用%4$s替换了位于%1$s, %2$s, %3$s的槽位	已用 %4$s 替換位於 %1$s, %2$s, %3$s 的欄位
已用%2$s替换了%1$s个实体的槽位	已用 %2$s 替換 %1$s 個實體上的欄位
已用%2$s替换了%1$s的槽位	已用 %2$s 替換 %1$s 上的欄位
来源没有%s槽位	該來源並沒有 %s 欄位
在来源位置%s, %s, %s上的不是一个容器	來源位置 %s, %s, %s 並非容器
没有对象在%2$s槽位接受了物品%1$s	沒有任何對象的 %2$s 欄位接收到物品 %1$s
没有对象在%s槽位接受了物品	沒有任何對象的 %s 欄位接收到物品
对象没有%s槽位	該對象並無 %s 欄位
在目标位置%s, %s, %s上的不是一个容器	指定的位置 %s, %s, %s 並非容器
无法转储JFR记录：%s	無法傾出 JFR 紀錄：%s
无法开始JFR分析	無法開始 JFR 分析
已开始JFR分析	開始進行 JFR 分析
JFR分析已结束，已转储至%s	已停止 JFR 分析，分析內容已傾出至 %s
无法在局域网游戏中踢出服务器所有者	無法在區網遊戲中踢出伺服器擁有者
无法在离线单人游戏中踢出玩家	無法在離線單人遊戲踢出玩家
已踢出%s：%s	%s 已被踢出：%s
杀死了%s个实体	已消滅 %s 個實體
杀死了%s	已消滅 %s
%s（%s）	%s (%s)
当前共有%s名玩家在线（最大玩家数为%s）：%s	目前有 %s/%s 個玩家在線上：%s
无法在合理距离内找到类型为“%s”的生物群系	無法在合理距離內找到 "%s" 類型的生態域
最近的%s位于%s（%s个方块外）	最接近的 %s 位於 %s（距離 %s 個方塊遠）
无法在合理距离内找到类型为“%s”的兴趣点	無法在合理距離內找到 "%s" 類型的興趣點
没有类型为“%s”的结构	沒有類型為 "%s" 的結構
无法在附近找到类型为“%s”的结构	無法在附近找到類型為 "%s" 的結構
%s悄悄地对你说：%s	%s 悄悄對您說：%s
你悄悄地对%s说：%s	您悄悄對 %s 說：%s
无变化，此玩家已是管理员	未進行任何變更。該玩家已是管理員
已将%s设为服务器管理员	已將 %s 設為伺服器管理員
无变化，该玩家未被封禁	未進行任何變更。該玩家未被封鎖
已解封%s	已解除封鎖 %s
无变化，该IP地址未被封禁	未進行任何變更。該 IP 未被封鎖
无效的IP地址	無效的 IP 位址
已解封IP地址%s	已解除封鎖 IP %s
该粒子无法被任何玩家看见	此粒子效果無法被任何玩家看見
正在显示粒子%s	顯示粒子 %s
性能分析器已在运行	效能分析器已在執行中
性能分析器尚未启动	效能分析器未啟動
生成调试报告失败	無法建立除錯報告
已在%s生成调试报告	已將除錯報告建立於 %s
已开始时长为10秒的性能分析测试（使用“/perf stop”以提前结束）	已啟用持續 10 秒的效能分析測試（使用 '/perf stop' 以提前結束）
已停止性能分析，用时%s秒和%s刻（每秒%s刻）	效能分析已停止，總共耗時 %s 秒和 %s 刻 (%s 刻/秒)
放置地物失败	無法放置該地物
没有类型为“%s”的地物	沒有類型為 "%s" 的地物
已在%2$s, %3$s, %4$s处放置“%1$s”	已於 %2$s, %3$s, %4$s 處放置 "%1$s"
生成拼图失败	無法生成拼圖
没有类型为“%s”的模板池	沒有類型為 "%s" 的模板池
已在%s, %s, %s处生成拼图	已於 %s, %s, %s 處生成拼圖
放置结构失败	無法放置該結構
已在%2$s, %3$s, %4$s处生成结构“%1$s”	已於 %2$s, %3$s, %4$s 處生成結構 "%1$s"
放置模板失败	無法放置該模板
没有ID为“%s”的模板	沒有 ID 為 "%s" 的模板
已在%2$s, %3$s, %4$s处加载模板“%1$s”	已於 %2$s, %3$s, %4$s 處載入模板 "%1$s"
声音过远而无法被听见	此音效太遠無法被聽見
已将声音%s播放给%s名玩家	已將音效 %s 播放給 %s 個玩家
已将声音%s播放给%s	已將音效 %s 播放給 %s
已存在开放于%s端口的多人游戏	主機連接埠 %s 上已經建立了多人遊戲
无法建立本地游戏	無法公開遊戲至區域網
本地游戏已在端口%s上开启	已在 %s 連接埠上發布本機遊戲
多人游戏已在%s端口上开启	多人遊戲已建立於主機連接埠 %s
随机值的范围最大为2147483646	隨機值範圍最大為 2147463646
随机值的范围最小为2	隨機值範圍最小為 2
已重置%s个随机序列	已重設 %s 個隨機序列
已重置随机序列%s	已重設隨機序列 %s
%s掷出了%s（从%s到%s）	%s 擲出了 %s（在 %s 和 %s 之間）
随机值：%s	隨機值：%s
没有新配方被解锁	沒有學到新的配方
已为%2$s名玩家解锁了%1$s条配方	已為 %2$s 個玩家解鎖了 %1$s 條合成配方
已为%2$s解锁了%1$s条配方	已為 %2$s 解鎖了 %1$s 條合成配方
没有可遗忘的配方	沒有可以被遺忘的配方
已剥夺%2$s名玩家的%1$s条配方	已移除 %2$s 個玩家的 %1$s 條合成配方
已剥夺%2$s的%1$s条配方	已移除 %2$s 的 %1$s 條合成配方
重新加载失败，保留原有数据	重新載入失敗，保留原有資料
重新加载中！	重新載入中！
%s已经在骑乘%s	%s 已在騎乘 %s
%s已停止骑乘%s	%s 結束騎乘 %s
玩家无法被骑乘	無法騎乘玩家
%s无法骑乘%s	%s 無法騎乘 %s
无法让实体骑乘自身或其乘客	實體不能騎乘自身或是其乘客
无法骑乘位于不同维度的实体	無法騎乘位於不同維度的實體
%s已开始骑乘%s	%s 開始騎乘 %s
%s未骑乘任何载具	%s 未騎乘任何載具
已旋转%s	已旋轉 %s
已经关闭世界保存	儲存功能已經關閉
已经打开世界保存	儲存功能已經開啟
自动保存已禁用	自動存檔已停用
自动保存已启用	自動存檔已啟用
无法保存游戏（磁盘空间是否足够？）	無法儲存遊戲（有足夠的磁碟空間嗎？）
正在保存游戏（这可能需要一些时间！）	正在儲存遊戲（這可能需要一點時間！）
游戏已保存	遊戲已儲存
没有ID为%s的计划	沒有 ID 為 %s 的排程
已移除%s个ID为%s的计划	移除 ID 為 %2$s 的 %1$s 個排程
已将函数“%s”计划在%s刻后，即游戏时间%s时执行	已將函數 '%1$s' 排定於 %2$s 刻後，遊戲時間為 %3$s
已将标签“%s”计划在%s刻后，即游戏时间%s时执行	已將標籤 '%s' 排定於 %s 刻後，遊戲時間為 %s
无法计划宏	無法排定巨集
无法将函数计划在当前刻	無法排定於當前刻
已经存在同名记分项	已存在使用該名稱的目標
创建了新的记分项%s	建立新的目標 %s
无变化，该显示位置本就是空的	未進行任何變更。顯示區已經是空的
无变化，该显示位置已经存在该记分项	未進行任何變更。顯示區已顯示該目標
清空了显示位置%s的所有记分项	已清除 %s 顯示區的所有目標
已将显示位置%s设置为展示记分项%s	已將目標 %2$s 顯示於 %1$s 的顯示區
不存在任何记分项	目前沒有目標
共有%s个记分项：%s	目前有 %s 個目標： %s
已禁用记分项%s的展示自动更新	已停用目標 %s 的顯示自動更新
已启用记分项%s的展示自动更新	已啟用目標 %s 的顯示自動更新
已将%s的显示名称更改为%s	已將 %s 的顯示名稱更改為 %s
已清除记分项%s的默认数字格式	已清除目標 %s 的預設數字格式
已更改记分项%s的默认数字格式	已變更目標 %s 的預設數字格式
已更改记分项%s的渲染类型	已變更目標 %s 的顯示類型
移除了记分项%s	已移除目標 %s
将%3$s个实体的%2$s增加了%1$s	已為 %3$s 個實體的 %2$s 增加 %1$s
将%3$s的%2$s增加了%1$s（现在是%4$s）	已為 %3$s 的 %2$s 增加 %1$s（目前為 %4$s）
已清除%s个实体在%s中的显示名称	已清除 %s 個實體在 %s 中的顯示名稱
已清除%s在%s中的显示名称	已清除 %s 在 %s 中的顯示名稱
已将%2$s个实体在%3$s中的显示名称更改为%1$s	已將 %2$s 個實體在 %3$s 中的顯示名稱變更為 %1$s
已将%2$s在%3$s中的显示名称更改为%1$s	已將 %2$s 在 %3$s 中的顯示名稱變更為 %1$s
已清除%s个实体在%s中的数字格式	已清除 %s 個實體在 %s 中的數字格式
已清除%s在%s中的数字格式	已清除 %s 在 %s 中的數字格式
已更改%s个实体在%s中的数字格式	已變更 %s 個實體在 %s 中的數字格式
已更改%s在%s中的数字格式	已變更 %s 在 %s 中的數字格式
无变化，触发器原已开启	未進行任何變更。該觸發項目已經啟用
只能启用trigger类记分项	啟用僅作用於觸發類型的目標
已为%2$s个实体启用了触发器%1$s	已在 %2$s 個實體上啟用觸發項目 %1$s
已为%2$s启用了触发器%1$s	已在 %2$s 上啟用觸發項目 %1$s
无法获取%2$s的%1$s的值，其尚未被赋值	無法取得 %2$s 的 %1$s 數值，數值未設定
%1$s在%3$s记分项里拥有%2$s分	%s 擁有 %s %s
没有正被追踪的实体	目前沒有追蹤的實體
%s无可显示的分数	%s 沒有分數可以顯示
%s：%s	%s：%s
%s拥有%s项分数：	%s 有 %s 個分數：
共有%s个正被追踪的实体：%s	目前追蹤了 %s 個實體： %s
更新了%2$s个实体的%1$s	已更新 %2$s 個實體的 %1$s
已将%2$s的%1$s设为%3$s	已將 %2$s 的 %1$s 設為 %3$s
已将%3$s个实体的%2$s分数减少%1$s	已從 %3$s 個實體的 %2$s 移除 %1$s
已将%3$s的%2$s减少%1$s（现在是%4$s）	已從 %3$s 的 %2$s 移除 %1$s（現在是 %4$s）
重置了%s个实体的所有分数	已重設 %s 個實體的所有分數
重置了%s的所有分数	已重設 %s 的所有分數
重置了%2$s个实体的%1$s	已重設 %2$s 個實體的 %1$s
重置了%2$s的%1$s	已重設 %2$s 的 %1$s
已将%2$s个实体的%1$s设为%3$s	已將 %2$s 個實體的 %1$s 設為 %3$s
已将%2$s的%1$s分数设为%3$s	已將 %2$s 的 %1$s 設為 %3$s
种子：%s	世界種子碼：%s
无法放置方块	無法放置方塊
更改了位于%s, %s, %s的方块	已變更位於 %s, %s, %s 的方塊
玩家的闲置限时现在为%s分钟	已將玩家閒置踢出時間設定為 %s 分鐘
玩家的闲置限时已禁用	已停用玩家閒置踢出
只能为主世界设置世界出生点	只能在主世界設定世界重生點
已将世界的出生点设置为%s, %s, %s [%s]	已將世界重生點設為 %s, %s, %s [%s]
已将%6$s名玩家的出生点设为%5$s中的%1$s, %2$s, %3$s [%4$s]	已將 %6$s 個玩家的重生點設為 %5$s 中的 %1$s, %2$s, %3$s [%4$s]
已将%6$s的出生点设为%5$s中的%1$s, %2$s, %3$s [%4$s]	已將 %6$s 的重生點設為 %5$s 中的 %1$s, %2$s, %3$s [%4$s]
%s尚未处于旁观模式	%s 不處於旁觀者模式
不能旁观自己	無法旁觀你自己
正在旁观%s	正在旁觀 %s
不再旁观实体	不再旁觀實體
%1$s个实体未能围绕%2$s, %3$s分散（空间过小而实体过多，请将分散间距设为%4$s以下）	未能將 %s 個實體分散至 (%s, %s) 周圍（空間中實體過多 – 請嘗試將分散範圍調整為至多 %s 格）
无效的maxHeight值：%s，应高于世界最小高度%s	無效的 maxHeight 值：%s，應高過世界最小高度 %s
%1$s支队伍未能围绕%2$s, %3$s分散（空间过小而实体过多，请将分散间距设为%4$s以下）	未能將 %s 個隊伍分散至 (%s, %s) 周圍（空間中實體過多 – 請嘗試將分散範圍調整為至多 %s 格）
已将%s个实体围绕%s, %s分散，平均距离为%s个方块	已將 %s 個實體分散於 (%s, %s) 附近， 每個實體之間的平均距離為 %s 格
已将%s支队伍围绕%s, %s分散，平均距离为%s个方块	已將 %s 個隊伍分散於 (%s, %s) 附近， 每個隊伍之間的平均距離為 %s 格
正在关闭服务器	正在停止伺服器
已停止播放所有“%s”的声音	已停止所有來自 '%s' 的音效
已停止播放来源为“%2$s”的音效“%1$s”	已停止來自音源 '%2$s' 的音效 '%1$s'
已停止播放所有声音	已停止所有的音效
已停止播放声音“%s”	已停止音效 '%s'
无法召唤实体	無法召喚實體
无法在和平难度下召唤怪物	在和平難易度下無法召喚怪物
UUID重复，无法召唤实体	UUID 重複，無法召喚實體
无效的召唤坐标	無效的召喚座標
召唤了新的%s	已召喚新的 %s
对象已拥有此标签或拥有过多标签	該對象已擁有此標籤或擁有過多標籤
已为%2$s个实体添加了标签“%1$s”	已為 %2$s 個實體加上了 '%1$s' 標籤
已为%2$s添加了标签“%1$s”	已為 %2$s 加上了 '%1$s' 標籤
%s个实体没有任何标签	這 %s 個實體上沒有標籤
%s个实体拥有共计%s项标签：%s	這 %s 個實體總共有 %s 個標籤：%s
%s没有标签	%s 沒有標籤
%s拥有%s个标签：%s	%s 有 %s 個標籤：%s
对象没有这个标签	該對象沒有這個標籤
已移除%2$s个实体的标签“%1$s”	已從 %2$s 個實體上移除了 '%1$s' 標籤
已移除%2$s的标签“%1$s”	已從 %2$s 上移除了 '%1$s' 標籤
已经存在同名队伍	已存在使用該名稱的隊伍
已创建队伍%s	已建立隊伍 %s
已将%s名成员从队伍%s中移除	已從隊伍 %2$s 中移除 %1$s 個成員
无变化，该队伍本就是空的	未進行任何變更。該隊伍已經是空的
已将%s名成员加入队伍%s	已將 %s 個成員加入隊伍 %s
已将%s加入队伍%s	已將 %s 加入隊伍 %s
已将%s名成员从所有队伍中移除	已將 %s 個成員從所有隊伍中移除
已将%s从所有队伍中移除	已將 %s 從隊伍中移除
队伍%s中没有成员	隊伍 %s 中沒有成員
队伍%s含有%s名成员：%s	隊伍 %s 有 %s 個成員： %s
没有队伍存在	沒有隊伍存在
共有%s支队伍：%s	共有 %s 個隊伍： %s
队伍%s的碰撞规则现在是“%s”	隊伍 %s 現在的碰撞規則為 "%s"
无变化，碰撞规则已经是此值	未進行任何變更。碰撞規則已為該數值
队伍%s的颜色已更新为%s	將隊伍 %s 的顏色更新為 %s
无变化，此队伍本就为此颜色	未進行任何變更。隊伍已擁有該顏色
队伍%s的死亡消息可见性现在为“%s”	隊伍 %s 現在的死亡訊息可見度為「%s」
无变化，死亡消息的可见性已经是此值	未進行任何變更。死亡訊息的可見度已為該數值
无变化，友军伤害本就在此队伍上禁用	未進行任何變更。該隊伍已經停用同隊相殘
无变化，友军伤害本就在此队伍上启用	未進行任何變更。該隊伍已經啟用同隊相殘
已禁用队伍%s的友军伤害	已為隊伍 %s 關閉同隊相殘
已启用队伍%s的友军伤害	已為隊伍 %s 啟用同隊相殘
已更新队伍%s的名称	已更新隊伍 %s 的名稱
无变化，此队伍本就为该名称	未進行任何變更。隊伍已擁有該名稱
队伍%s的名称标签可见性现在为“%s”	隊伍 %s 現在的名稱可見度為「%s」
无变化，名称标签的可见性已经是此值	未進行任何變更。名牌可見度已為該數值
队伍前缀已设为%s	隊伍前綴已設為 %s
无变化，此队伍本就不可看见隐身的队友	未進行任何變更。該隊伍已經看不見隱身的隊友
无变化，此队伍本就可以看见隐身的队友	未進行任何變更。該隊伍已經可以看到隱身的隊友
队伍%s不再可以看见隐身的队友了	隊伍 %s 現在看不到隱身的隊友了
队伍%s现在可以看见隐身的队友了	隊伍 %s 現在可以看到隱身的隊友了
队伍后缀已设为%s	隊伍後綴已設為 %s
移除了队伍%s	已移除隊伍 %s
你必须在一支队伍内才能发出队伍消息	你必須在隊伍中才能傳送隊伍訊息
无效的传送坐标	無效的傳送座標
已传送%s个实体至%s	已傳送 %s 個實體到 %s
已将%s传送至%s	傳送 %s 到 %s
已传送%s个实体至%s, %s, %s	已傳送 %s 個實體到 %s, %s, %s
已将%s传送至%s, %s, %s	傳送 %s 到 %s, %s, %s
正在启动环境%s批次%s	正在啟動環境 %s 批次 %s
无法找到任何需要清除的测试	找不到任何需要清除的測試
清除了%s个结构	已清除 %s 個結構
已为测试%s创建测试设置	已為測試 %s 建立測試設定
找不到包含%s, %s, %s的测试实例	找不到包含 %s, %s, %s 的測試實例
未找到测试实例	未找到測試實例
测试%s不存在	無法找到測試 %s
无法找到测试结构%s	無法找到測試結構 %s
无法找到测试实例方块实体	無法找到測試實例方塊實體
无法在%s, %s, %s处找到测试实例方块实体	無法在 %s, %s, %s 處找到測試實例方塊實體
结构在每条轴上的大小必须小于%s个方块	結構在每個軸上的長度皆須小於 %s 個方塊
定位完成，找到%s个结构	定位完成，找到了 %s 個結構
在以下位置找到结构：%s（距离：%s）	在下列位置找到結構：%s（距離：%s）
已开始定位测试结构，这可能需要一点时间…	開始定位測試結構，這可能需要一點時間...
没有需要运行的测试	沒有需要執行的測試
相对于%s的位置：%s	相對 %s 的位置：%s
无法找到任何需要重置的测试	找不到任何需要重設的測試
重置了%s个结构	已重設 %s 個結構
未找到测试	未找到任何測試
正在运行%s个测试…	正在執行 %s 個測試...
游戏测试完成！已运行%s个测试	遊戲測試完成！執行了 %s 個測試
必要测试均已通过 :)	必要測試均已通過 :)
%s个必要测试失败 :(	%s 個必要測試失敗 :(
%s个可选测试失败	%s 個可選測試失敗
百分位数：50%%：%s毫秒 95%%：%s毫秒 99%%：%s毫秒，共采样：%s	百分位數：50%%：%s 毫秒，95%%：%s 毫秒，99%%：%s 毫秒；共取樣：%s
目标速率：%s刻每秒。\n每刻平均时间：%s毫秒（目标：%s毫秒）	目標速率：每秒 %s 刻。\n每刻平均時間：%s 毫秒（目標：%s 毫秒）
目标速率：%s刻每秒（已忽略，仅供参考）。\n每刻平均时间：%s毫秒	目標速率：每秒 %s 刻（已忽略，僅供參考）。\n每刻平均時間：%s 毫秒
已设置目标速率为每秒%s刻	已將目標速率設為每秒 %s 刻
游戏加速已完成，速率为每秒%s刻，即每刻%s毫秒	遊戲刻加速已完成，速率為每秒 %s 刻，即每刻 %s 毫秒
没有正在执行的游戏刻加速	沒有正在執行的遊戲刻加速
当前游戏刻加速已中止	已中止目前的遊戲刻加速
游戏冻结中	遊戲已定格
游戏正在运行，但无法达到目标速率	遊戲正在執行，但無法維持目標速率
游戏正在以正常速度运行	遊戲正在以正常速率執行
游戏加速运行中	遊戲加速執行中
无法步进游戏，请先冻结游戏	無法步進遊戲，請先定格遊戲
没有正在执行的游戏刻步进	沒有正在執行的遊戲刻步進
当前游戏刻步进已中止	已中止目前的遊戲刻步進
正在步进%s刻	正在步進 %s 刻
当前时间为%s	目前時間為 %s
已将时间设为%s	設定時間為 %s
已清除%s名玩家的标题	已清除 %s 個玩家的標題
已清除%s的标题	已清除 %s 的標題
已重置%s名玩家的标题设置	已重設 %s 個玩家的標題設定
已重置%s的标题设置	已重設 %s 的標題設定
正在向%s名玩家显示新的动作栏标题	已對 %s 個玩家顯示了新的動作欄標題
正在向%s显示新的动作栏标题	已對 %s 顯示了新的動作欄標題
正在向%s名玩家显示新的副标题	已對 %s 個玩家顯示了新的副標題
正在向%s显示新的副标题	已對 %s 顯示了新的副標題
正在向%s名玩家显示新的标题	已對 %s 個玩家顯示了新的標題
正在向%s显示新的标题	已對 %s 顯示了新的標題
已更改%s名玩家的标题显示时间	已變更 %s 個玩家的標題顯示時間
已更改%s的标题显示时间	已變更 %s 的標題顯示時間
必须至少指定一个待转移的玩家	必須至少指定一個待轉移的玩家
正在转移%s个玩家至%s:%s	正在轉移 %s 個玩家至 %s:%s
正在转移%s至%s:%s	正在轉移 %s 至 %s:%s
已触发%s（数值已增加%s）	已觸發 %s（將數值增加 %s）
你只能触发“trigger”类型的记分项	你只能觸發 'trigger' 類型的目標
你尚无法触发这个记分项	你還無法觸發這個目標
已触发%s（数值已设为%s）	已觸發 %s（將數值設為 %s）
已触发%s	已觸發 %s
build_time = %s	build_time = %s
data = %s	data = %s
Server version info:	Server version info:
id = %s	id = %s
name = %s	name = %s
pack_data = %s	pack_data = %s
pack_resource = %s	pack_resource = %s
protocol = %s (%s)	protocol = %s (%s)
series = %s	series = %s
stable = no	stable = no
stable = yes	stable = yes
在%s内没有路径点	%s 內沒有路徑點
在%2$s内找到%1$s个路径点：%3$s	在 %2$s 內找到 %1$s 個路徑點：%3$s
路径点颜色现在为%s	已將路徑點顏色設為 %s
已重置路径点颜色	已重設路徑點顏色
已更改路径点样式	已變更路徑點樣式設定
天气已设为晴天	已將天氣設為晴朗
天气已设为雨天	已將天氣設為降雨
天气已设为雷雨	已將天氣設為雷雨
玩家已在白名单内	玩家已在白名單內
已将%s加入白名单	已新增 %s 到白名單
白名单原已关闭	白名單已經關閉
白名单原已开启	白名單已經啟用
白名单已关闭	已關閉白名單
白名单已开启	已啟用白名單
白名单中共有%s名玩家：%s	以下 %s 個玩家在白名單中：%s
白名单中没有玩家	沒有玩家在白名單中
已重新读取白名单	已重新載入白名單
玩家不在白名单内	玩家不在白名單內
已将%s移出白名单	已將 %s 從白名單中移除
无变化，世界边界中心点已经在该处	未進行任何變更。世界邊界中心已經設定於該處
已将世界边界的中心设为%s, %s	已將世界邊界的中心設為 %s, %s
无变化，世界边界伤害已经是此值	未進行任何變更。世界邊界傷害已為該值
已将世界边界的伤害设置为%s每秒每个方块	已將世界邊界每秒的傷害設為每遠離一格增加 %s
无变化，世界边界伤害缓冲区已经是此距离	未進行任何變更。世界邊界傷害緩衝區已為該距離
已将世界边界的伤害缓冲区设置为%s个方块	已將世界邊界傷害緩衝設為 %s 格
世界边界的当前宽度为%s个方块	世界邊界目前為 %s 格寬
世界边界的宽度不能大于%s格	世界邊界不能大於 %s 格寬
世界边界的位置不能远于%s格	世界邊界不能大於 %s 格寬
无变化，世界边界已经是此大小	未進行任何變更。世界邊界已為該尺寸
世界边界的宽度不能小于1格	世界邊界不能小於 1 格寬
正在将世界边界的宽度扩大为%s个方块，时间%s秒	在 %2$s 秒間將世界邊界擴增為 %1$s 格寬
已将世界边界的宽度设为%s	已將世界邊界設為 %s 格寬
正在将世界边界的宽度缩小为%s个方块，用时%s秒	在 %2$s 秒間將世界邊界縮減為 %1$s 格寬
无变化，世界边界伤害警告区已经是此距离	未進行任何變更。世界邊界警告距離已為該距離
已将世界边界的警告距离设置为%s个方块	已將世界邊界警告距離設為 %s 格
无变化，世界边界警告时间已经是此时长	未進行任何變更。世界邊界警告時間已為該時間
已将世界边界的警告时间设置为%s秒	已將世界邊界警告時間設為 %s 秒
你的游戏时长已超过24小时	您已經遊玩超過 24 小時
你的游戏时长已达%s小时	您已經遊玩了 %s 小時
适度游戏益脑，沉迷游戏伤身	遊戲過度可能會影響日常生活
连接中断	已中止
登录中…	登入中...
正在连接到服务器…	正在連線到伺服器...
通讯加密中…	加密中...
无法连接至服务器	與伺服器連線失敗
转移到服务器时连接失败	轉移至伺服器時連線失敗
加入世界中…	正在加入世界...
连接协商中…	協議中...
重新配置中…	重新設定中...
正在转移至新的服务器…	正在轉移至新的伺服器...
蜜蜂：%s/%s	蜜蜂：%s / %s
蜂蜜：%s/%s	蜂蜜：%s / %s
大型箱子	大型儲物箱
合成	合成
物品选栏	選擇物品
附魔	附魔
%s…？	%s . . . ？
花费：%s颗青金石	%s 個青金石
花费：1颗青金石	1 個青金石
+ %s级经验	%s 個附魔等級
+ 1级经验	1 個附魔等級
等级要求：%s	等級需求：%s
修复和祛魔	修復與解除附魔
物品栏	物品欄
%s已被上锁！	%s 已鎖上！
修复和命名	修復與命名
附魔花费：%1$s	附魔成本：%1$s
过于昂贵！	太貴了！
%s ×%s	%s ×%s
还有%s项未显示…	還有 %s 件物品...
???????	???????
无法打开：战利品尚未生成。	無法開啟。戰利品尚未生成。
升级装备	升級裝備
该物品无法用此方式升级	物品無法使用此方式升級
放入锻造模板	放置鍛造模板
按键绑定…	按鍵綁定...
该按键也用于：\n%s	此按鍵也用於：\n%s
按键绑定	按鍵綁定
重置	重設
重置按键	重設按鍵
按键控制	按鍵設定
请选择一种生物群系	請選擇一種生態域
自定义单一生物群系	單一自訂生態域
高度	高度
%s	%s
底层 - %s	底層 - %s
顶层 - %s	頂層 - %s
移除层面	移除地層
各层的材料	地層組成
自定义超平坦世界	自訂超平坦世界
预设	方案集
另外，这里是些我们早期制作好的！	您也可以選擇預先設定的地形！
使用预设	使用此方案
想要与别人分享你的预设方案吗？使用下面的输入框吧！	想與人分享您的地形方案嗎？請使用下方的文字框！
选择一种预设	選擇一種方案
正在准备生成世界…	正在準備建立世界...
游戏	遊戲
更多	更多
世界	世界
著作权说明	著作權
鸣谢名单	製作人員名單
许可协议	授權條款
鸣谢与著作权说明	鳴謝
启用实验性收纳袋物品	啟用實驗性束口袋物品
收纳袋	束口袋
在多人游戏中显示其他玩家的方位	在多人遊戲中顯示其他玩家的方位
定位栏	定位條
改进了矿车的运动	改進礦車的移動
矿车改进	礦車改進
实验性红石更改	實驗性紅石變更
红石实验性内容	紅石實驗性內容
选择数据包	選擇資料包
新版村民交易	新版村民交易系統
村民交易的平衡性调整	重新平衡村民交易
Minecraft 1.20的新功能与内容	Minecraft 1.20 的新功能及內容
1.20更新	1.20 更新
Minecraft 1.21的新功能与内容	Minecraft 1.21 的新功能與內容
1.21更新	1.21 更新
返回	返回
数据包验证失败！	資料包驗證失敗！
重置为默认	重設為預設值
正在验证选中的数据包…	正在驗證所選的資料包...
Minecraft的默认数据包	Minecraft 預設的資料包
默认	預設
冬季小更新的新功能与内容	冬季小更新的新功能與內容
冬季小更新	冬季小更新
安全模式	安全模式
这个世界包含无效或损坏的存档数据。	此世界含有無效或毀損的儲存資料。
无法在安全模式下加载世界。	無法在安全模式下載入世界。
当前选中的数据包中出现了错误，导致世界无法加载。\n你可以尝试仅加载原版数据包（“安全模式”）或回到标题屏幕手动修复该问题。	目前選擇的資料包中出現錯誤，導致世界無法載入。\n您可以嘗試只載入原版資料包（「安全模式」）或是回到標題畫面手動修復。
%1$s被下落的铁砧压扁了	%1$s 被墜落下來的鐵砧壓扁了
%1$s在与%2$s战斗时被下落的铁砧压扁了	%1$s 在與 %2$s 戰鬥時被落下的鐵砧壓扁
%1$s被%2$s射杀	%1$s 被 %2$s 射殺了
%1$s被%2$s用%3$s射杀	%1$s 被 %2$s 用 %3$s 射殺
刻意的游戏设计	刻意的遊戲設計
%1$s被%2$s杀死了	%1$s 被 %2$s 殺死了
%1$s被戳死了	%1$s 被仙人掌刺死了
%1$s在试图逃离%2$s时撞上了仙人掌	%1$s 在試圖逃離 %2$s 時被仙人掌刺死了
%1$s因被过度挤压而死	%1$s 遭到擠壓致死
%1$s被%2$s挤扁了	%1$s 遭到 %2$s 擠壓致死
%1$s被龙息烤熟了	%1$s 被龍之吐息烤熟了
%1$s被%2$s的龙息烤熟了	%1$s 被 %2$s 的龍之吐息烤熟了
%1$s淹死了	%1$s 溺死了
%1$s在试图逃离%2$s时淹死了	%1$s 在試圖逃離 %2$s 時在水中溺斃
%1$s因脱水而死	%1$s 脫水而死
%1$s在试图逃离%2$s时因脱水而死	%1$s 在試圖逃離 %2$s 時脫水而死
%1$s被不为人知的魔法杀死了	%1$s 被深不可測的力量殺死了
%1$s爆炸了	%1$s 被炸飛了
%1$s被%2$s炸死了	%1$s 被 %2$s 炸死了
%1$s被%2$s用%3$s炸死了	%1$s 被 %2$s 用 %3$s 炸死
%1$s落地过猛	%1$s 以為能安然無恙的著地
%1$s在试图逃离%2$s时落地过猛	%1$s 在試圖逃離 %2$s 時失足墜地
%1$s被下落的方块压扁了	%1$s 被墜落下來的方塊壓扁了
%1$s在与%2$s战斗时被下落的方块压扁了	%1$s 在與 %2$s 戰鬥時被落下的方塊壓扁
%1$s被下落的钟乳石刺穿了	%1$s 被墜落的鐘乳石刺穿了
%1$s在与%2$s战斗时被下落的钟乳石刺穿了	%1$s 在與 %2$s 戰鬥時被落下的鐘乳石刺穿
%1$s被%2$s用火球烧死了	%1$s 被 %2$s 的火球殺死了
%1$s被%2$s用%3$s发射的火球烧死了	%1$s 被 %2$s 用 %3$s 打出的火球殺死
%1$s随着一声巨响消失了	%1$s 在爆炸中犧牲了
%1$s随着%2$s用%3$s发射的烟花发出的巨响消失了	%1$s 在 %2$s 用 %3$s 發射的煙火所產生的爆炸中犧牲了
%1$s在与%2$s战斗时随着一声巨响消失了	%1$s 在與 %2$s 戰鬥時隨著爆炸逝去
%1$s感受到了动能	%1$s 體驗了動能
%1$s在试图逃离%2$s时感受到了动能	%1$s 在試圖逃離 %2$s 時體驗了動能
%1$s被冻死了	%1$s 凍死了
%1$s被%2$s冻死了	%1$s 被 %2$s 凍死了
%1$s死了	%1$s 死亡
%1$s死于%2$s	%1$s 因 %2$s 而死
%1$s被杀死了	%1$s 被殺死了
%1$s在与%2$s战斗时被杀死了	%1$s 在與 %2$s 戰鬥時被殺死了
%1$s发现了地板是熔岩做的	%1$s 察覺地面是片熔岩
%1$s因%2$s而步入危险之地	%1$s 因為 %2$s 而走進了危險地帶
%1$s浴火焚身	%1$s 在火焰中昇天
%1$s在与%2$s战斗时不慎走入了火中	%1$s 在與 %2$s 戰鬥時踏入了火中
%1$s在墙里窒息而亡	%1$s 在牆壁裡窒息
%1$s在与%2$s战斗时在墙里窒息而亡	%1$s 在與 %2$s 戰鬥時卡進牆裡窒息
%1$s被%2$s使用的魔法杀死了	%1$s 被 %2$s 用魔法殺死
%1$s被%2$s用%3$s杀死了	%1$s 被 %2$s 用 %3$s 殺死
%1$s试图在熔岩里游泳	%1$s 試圖在熔岩中游泳
%1$s在逃离%2$s时试图在熔岩里游泳	%1$s 跳入熔岩試圖逃離 %2$s 的追殺
%1$s被闪电击中	%1$s 被閃電擊斃
%1$s在与%2$s战斗时被闪电击中	%1$s 在與 %2$s 戰鬥時被閃電擊斃
%1$s被%2$s一锤毙命	%1$s 被 %2$s 錘爆了
%1$s被%2$s用%3$s一锤毙命	%1$s 被 %2$s 用 %3$s 錘爆了
%1$s被魔法杀死了	%1$s 被魔法殺死了
%1$s在试图逃离%2$s时被魔法杀死了	%1$s 在試圖逃離 %2$s 時被魔法殺死了
抱歉！消息太长，无法完整显示。截断后的消息：%s	死亡訊息過長而無法完整送出。非常抱歉！以下為截短後的版本：%s
%1$s被烧死了	%1$s 被燒死了
%1$s在与持有%3$s的%2$s战斗时被烤得酥脆	%1$s 在與手持 %3$s 的 %2$s 戰鬥時被火焰燒成灰燼
%1$s在与%2$s战斗时被烤得酥脆	%1$s 在與 %2$s 戰鬥時被火焰燒成灰燼
%1$s掉出了这个世界	%1$s 掉到世界外面了
%1$s与%2$s不共戴天	%1$s 不想和 %2$s 活在同一個世界
%1$s脱离了这个世界	%1$s 脫離了這個世界
%1$s在与%2$s战斗时脱离了这个世界	%1$s 在與 %2$s 戰鬥時脫離了這個世界
%1$s被一道音波尖啸抹除了	%1$s 被一道聲波尖嘯抹殺了
%1$s在试图逃离持有%3$s的%2$s时被一道音波尖啸抹除了	%1$s 在試圖逃離手持 %3$s 的 %2$s 時被一道聲波尖嘯抹殺了
%1$s在试图逃离%2$s时被一道音波尖啸抹除了	%1$s 在試圖逃離 %2$s 時被一道聲波尖嘯抹殺了
%1$s被石笋刺穿了	%1$s 在石筍上被刺穿
%1$s在与%2$s战斗时被石笋刺穿了	%1$s 在與 %2$s 戰鬥時在石筍上被刺穿
%1$s饿死了	%1$s 餓死了
%1$s在与%2$s战斗时饿死了	%1$s 在與 %2$s 戰鬥時餓死了
%1$s被蛰死了	%1$s 被螫死了
%1$s被%2$s用%3$s蛰死了	%1$s 被 %2$s 以 %3$s 螫死了
%1$s被%2$s蛰死了	%1$s 被 %2$s 螫死了
%1$s被甜浆果丛刺死了	%1$s 被甜莓灌木叢刺死了
%1$s在试图逃离%2$s时被甜浆果丛刺死了	%1$s 在試圖逃離 %2$s 時被甜莓灌木叢刺死了
%1$s在试图伤害%2$s时被杀	%1$s 試圖襲擊 %2$s 時被反將一軍
%1$s在试图伤害%2$s时被%3$s杀死	%1$s 試圖攻擊 %2$s 時死於 %3$s
%1$s被%2$s给砸死了	%1$s 被 %2$s 活生生揍死了
%1$s被%2$s用%3$s给砸死了	%1$s 被 %2$s 用 %3$s 揍死
%1$s被%2$s刺穿了	%1$s 被 %2$s 刺穿了
%1$s被%2$s用%3$s刺穿了	%1$s 被 %2$s 用 %3$s 刺穿了
%1$s凋零了	%1$s 凋零了
%1$s在与%2$s战斗时凋零了	%1$s 在與 %2$s 戰鬥時凋零了
%1$s被%2$s发射的头颅射杀	%1$s 被 %2$s 發射的頭顱射死了
%1$s被%2$s用%3$s发射的头颅射杀	%1$s 被 %2$s 以 %3$s 發射的頭顱射死了
%1$s从高处摔了下来	%1$s 從高處跌落
%1$s从梯子上摔了下来	%1$s 從梯子上摔落
%1$s在攀爬时摔了下来	%1$s 在攀爬時摔落
%1$s从脚手架上摔了下来	%1$s 從鷹架上摔落
%1$s从缠怨藤上摔了下来	%1$s 從扭曲藤上摔落
%1$s从藤蔓上摔了下来	%1$s 從藤蔓上摔落
%1$s从垂泪藤上摔了下来	%1$s 從垂泣藤上摔落
%1$s因为%2$s注定要摔死	%1$s 被 %2$s 擊落
%1$s因为%2$s使用了%3$s注定要摔死	%1$s 被 %2$s 以 %3$s 擊落
%1$s摔伤得太重并被%2$s完结了生命	%1$s 摔傷後被 %2$s 殺了
%1$s摔伤得太重并被%2$s用%3$s完结了生命	%1$s 摔傷後被 %2$s 以 %3$s 擊殺
%1$s注定要摔死	%1$s 從空中摔落地面
你确定要退出吗？	你確定要退出了嗎？
重生	重生
分数	分數
分数：%s	分數：%s
旁观世界	旁觀世界
你死了！	你死了！
游戏结束！	遊戲結束！
标题屏幕	標題畫面
F3 + H = 显示高级提示框	F3 + H = 進階提示
高级提示框：隐藏	進階提示：隱藏
高级提示框：显示	進階提示：顯示
F3 + G = 显示区块边界	F3 + G = 顯示區塊邊界
区块边界：隐藏	區塊邊界：隱藏
区块边界：显示	區塊邊界：顯示
F3 + D = 清空聊天记录	F3 + D = 清除聊天欄
F3 + C = 用/tp命令的形式复制你的位置，按住F3 + C使游戏崩溃	F3 + C = 將位置複製為 /tp 指令，按住 F3 + C 使遊戲崩潰
坐标已复制到剪贴板	將位置複製到剪貼簿
F3 + C已被按下。若不放开按键则会使游戏崩溃。	已按住 F3 + C。若未放開按鍵將使遊戲崩潰。
将在%s秒后崩溃…	遊戲崩潰倒數 %s...
你没有切换游戏模式的权限	無法切換遊戲模式，需要權限
F3 + N = 在上一个模式和旁观模式间切换	F3 + N = 循環切換 先前的遊戲模式 <-> 旁觀者模式
已将动态纹理保存至%s	已將動態紋理儲存至 %s
F3 + S = 转储动态纹理	F3 + S = 傾印動態紋理
始终显示	總是
%s：当前始终显示	%s：目前總是開啟
%s：当前仅F3	%s：目前僅於 F3
%s：当前关闭	%s：目前關閉
仅F3	僅於 F3
你没有权限打开游戏模式切换器	您沒有權限開啟遊戲模式切換器
F3 + F4 = 打开游戏模式切换器	F3 + F4 = 開啟遊戲模式切換器
[ F4 ]	[ F4 ]
%s 下一个	%s 下一個
F3 + Q = 显示此列表	F3 + Q = 顯示此清單
按键设置：	按鍵設定：
客户端方块数据已复制到剪贴板	已將用戶端方塊資料複製到剪貼簿
客户端实体数据已复制到剪贴板	已將用戶端實體資料複製到剪貼簿
F3 + I = 将实体或方块的数据复制到剪贴板	F3 + I = 將實體或方塊的資料複製到剪貼簿
服务端方块数据已复制到剪贴板	已將伺服器端方塊資料複製到剪貼簿
服务端实体数据已复制到剪贴板	已將伺服器端實體資料複製到剪貼簿
调试渲染器	除錯渲染器
调试屏幕文本	除錯畫面文字
F3 + F5 = 编辑调试选项	F3 + F5 = 編輯除錯選項
简化调试信息时隐藏	簡化除錯資訊時隱藏
默认配置	預設設定檔
性能监控配置	效能設定檔
搜索选项	搜尋除錯選項
调试选项	除錯選項
这些选项仅用于测试目的。它们可能会拖慢你的电脑，使游戏崩溃，或者点一碗酒吧里的炒饭。	這些選項僅供測試用途使用，可能會拖慢電腦速度或是使遊戲崩潰。
F3 + Esc = 暂停但不显示菜单（如果可以暂停的话）	F3 + Esc = 暫停遊戲但不顯示遊戲選單（若遊戲允許暫停）
F3 + P = 失去焦点时暂停	F3 + P = 在失焦時暫停
失去焦点时暂停：停用	在失去焦點時暫停：停用
失去焦点时暂停：启用	在失去焦點時暫停：啟用
[调试]：	[除錯]:
F3 + L = 开始/停止分析	F3 + L = 開始或停止分析
分析已启动%s秒。使用F3 + L以提前结束	已開始分析 %s 秒。使用 F3 + L 提前停止
分析已结束。结果已保存至%s	分析結束。已將結果儲存至 %s
F3 + A = 重新加载区块	F3 + A = 重新載入區塊
重新加载所有区块中	正在重新載入所有區塊
F3 + T = 重新加载资源包	F3 + T = 重新載入資源包
已重新加载资源包	已重新載入資源包
F3 + B = 显示判定箱	F3 + B = 顯示碰撞箱
判定箱：隐藏	碰撞箱：隱藏
判定箱：显示	碰撞箱：顯示
客户端版本信息：	用戶端版本資訊：
F3 + V = 显示客户端版本信息	F3 + V = 顯示用戶端版本資訊
此试玩版会在5个游戏日后结束，尽力而为吧！	試玩版只有五天的遊戲內時間。盡你所能吧！
第二天	第二天
第三天	第三天
第四天	第四天
这是你游戏内的最后一天！	這是你的最後一天！
你已经度过了5个游戏日的试玩时间，按下%s来为你的成果截图留念。	你度過了你的第五天。按下 %s 來為你的創作保存一張擷圖。
你的试玩时间即将结束！	你的時間即將結束！
试玩的时间结束了！	試玩時間結束！
即刻购买！	立即購買！
这个试玩将会持续游戏内5天的时间（现实时间大约为1小时40分钟）。查看进度来获得提示！祝你玩得开心！	你可以在遊戲中試玩五天（約為現實世界的 1 小時 40 分鐘）。在選單的「進度」選項中，可以找到一些有幫助的提示。希望你玩得開心！
按%1$s来打开你的物品栏	使用 %1$s 鍵來開啟您的物品欄
按%1$s来跳跃	按 %1$s 鍵跳躍
继续游戏！	繼續進行遊戲！
使用%1$s、%2$s、%3$s、%4$s以及鼠标来移动	使用 %1$s、%2$s、%3$s、%4$s 鍵與滑鼠來移動
使用鼠标来环顾四周	使用滑鼠以查看四周
通过按下%1$s、%2$s、%3$s、%4$s来移动	按下 %1$s、%2$s、%3$s、%4$s 鍵移動
Minecraft试玩模式	Minecraft 試玩模式
剩余时间：%s	剩餘時間：%s
试玩时间已经结束，请购买游戏来继续或开始一个新的世界！	試玩時間已經結束。請購買遊戲來繼續，或重新開始一個新的世界！
你确定你要锁定这个世界的难度吗？这会将这个世界的难度锁定为%1$s，并且永远无法再次改变难度。	你確定要鎖定這個世界的難易度嗎？ 這個世界的難易度將永久設為%1$s，且無法再被更改。
锁定世界难度	鎖定世界難易度
数据流终止	數據傳送終止
由于超出数据包速率限制而被踢出游戏	由於超過封包速率限制而被踢出遊戲
忽略状态请求	忽略狀態請求
登录失败：%s	登入失敗：%s
多人游戏已被禁用，请检查你的Microsoft账户设置。	多人遊戲已停用。請檢查您的 Microsoft 帳號設定。
无效会话（请尝试重启游戏及启动器）	無效的 session（請嘗試重開您的遊戲與啟動器）
暂时无法连接到身份验证服务器，请稍后再试。	目前無法連線到驗證伺服器。請稍後再試。
你已被禁止进行在线游戏	您已被禁止遊玩多人遊戲
连接已丢失	失去連線
网络协议错误	網路協定錯誤
由于滥发消息而被踢出游戏	因為濫發訊息被踢出
连接超时	連線逾時
已转移至另一个服务器	已轉移至另一個伺服器
未知的主机	未知的主機
有%s个包下载失败，共%s个包	%s 個資源包下載失敗，共 %s 個資源包
进度：%s（总大小未知）	進度：%s（總大小未知）
进度：%s%%	進度：%s%%
正在下载资源包%s/%s	正在下載資源包 %s/%s
默认：%s	預設值：%s
编辑游戏规则	編輯遊戲規則
∞	∞
伤害吸收	吸收
不祥之兆	不祥之兆
失明	失明
潮涌能量	海靈祝福
黑暗	黑暗
海豚的恩惠	海豚悠游
抗火	抗火
发光	發光
急迫	挖掘加速
生命提升	生命值提升
饥饿	飢餓
寄生	蛀蝕
瞬间伤害	立即傷害
瞬间治疗	立即治療
隐身	隱形
跳跃提升	跳躍提升
飘浮	懸浮
幸运	幸運
挖掘疲劳	挖掘疲勞
反胃	噁心
夜视	夜視
渗浆	滲漿
中毒	劇毒
袭击之兆	突襲之兆
生命恢复	回復
抗性提升	抗性
饱和	飽食
缓降	緩降
缓慢	緩速
迅捷	加速
力量	力量
试炼之兆	試煉之兆
霉运	霉運
水下呼吸	水下呼吸
虚弱	虛弱
盘丝	結網
蓄风	蘊風
凋零	凋零
无效果	無效果
I	I
X	X
II	II
III	III
IV	IV
V	V
VI	VI
VII	VII
VIII	VIII
IX	IX
水下速掘	親水性
节肢杀手	節肢剋星
绑定诅咒	綁定詛咒
爆炸保护	爆炸保護
破甲	破甲
引雷	喚雷
致密	緻密
深海探索者	深海漫遊
效率	效率
摔落缓冲	輕盈
火焰附加	燃燒
火焰保护	火焰保護
火矢	火焰
时运	幸運
冰霜行者	冰霜行者
穿刺	魚叉
无限	無限
抢夺	掠奪
忠诚	忠誠
海之眷顾	海洋的祝福
饵钓	魚餌
经验修补	修補
多重射击	分裂箭矢
穿透	貫穿
弹射物保护	投射物保護
保护	保護
冲击	衝擊
快速装填	快速上弦
激流	波濤
锋利	鋒利
精准采集	絲綢之觸
亡灵杀手	不死剋星
灵魂疾行	靈魂疾走
横扫之刃	橫掃之刃
迅捷潜行	迅捷潛行
荆棘	尖刺
耐久	耐久
消失诅咒	消失詛咒
风爆	風爆
金合欢木船	相思木船
金合欢木运输船	儲物箱相思木船
悦灵	悅靈
区域效果云	藥水效果雲
犰狳	犰狳
盔甲架	盔甲座
箭	箭矢
美西螈	六角恐龍
运输竹筏	儲物箱竹筏
竹筏	竹筏
蝙蝠	蝙蝠
蜜蜂	蜜蜂
白桦木船	樺木船
白桦木运输船	儲物箱樺木船
烈焰人	烈焰使者
方块展示实体	方塊展示實體
船	船
沼骸	沼骸
旋风人	旋風使者
风弹	風彈
骆驼	駱駝
猫	貓
洞穴蜘蛛	洞穴蜘蛛
樱花木船	櫻花木船
樱花木运输船	儲物箱櫻花木船
运输船	儲物箱船
运输矿车	儲物箱礦車
鸡	雞
鳕鱼	鱈魚
命令方块矿车	指令方塊礦車
铜傀儡	銅魔像
牛	牛
嘎枝	嘎枝
苦力怕	苦力怕
深色橡木船	黑橡木船
深色橡木运输船	儲物箱黑橡木船
海豚	海豚
驴	驢子
末影龙火球	龍炎彈
溺尸	沉屍
掷出的鸡蛋	拋出的雞蛋
远古守卫者	遠古深海守衛
末地水晶	終界水晶
末影龙	終界龍
掷出的末影珍珠	拋出的終界珍珠
末影人	終界使者
末影螨	終界蟎
唤魔者	喚魔者
唤魔者尖牙	喚魔者尖牙
掷出的附魔之瓶	拋出的經驗瓶
经验球	經驗球
末影之眼	終界之眼
下落的方块	掉落的方塊
下落的%s	掉落的 %s
火球	火球
烟花火箭	煙火
浮漂	浮標
狐狸	狐狸
青蛙	青蛙
动力矿车	熔爐礦車
恶魂	地獄幽靈
巨人	巨人
荧光物品展示框	螢光物品展示框
发光鱿鱼	螢光魷魚
山羊	山羊
守卫者	深海守衛
快乐恶魂	快樂幽靈
疣猪兽	豬布獸
漏斗矿车	漏斗礦車
马	馬
尸壳	屍殼
幻术师	幻術師
交互实体	互動實體
铁傀儡	鐵魔像
物品	物品
物品展示实体	物品展示實體
物品展示框	物品展示框
丛林木船	叢林木船
丛林木运输船	儲物箱叢林木船
杀手兔	殺手兔
拴绳结	拴繩
闪电束	閃電電流
滞留药水	滯留藥水
羊驼	駱馬
羊驼唾沫	駱馬唾液
岩浆怪	岩漿立方怪
红树木船	紅樹林木船
红树木运输船	儲物箱紅樹林木船
标记	標記
矿车	礦車
哞菇	哞菇
骡	騾子
橡木船	橡木船
橡木运输船	儲物箱橡木船
豹猫	山貓
不祥之物生成器	不祥物品生成器
画	繪畫
苍白橡木船	蒼白橡木船
苍白橡木运输船	儲物箱蒼白橡木船
熊猫	貓熊
鹦鹉	鸚鵡
幻翼	夜魅
猪	豬
猪灵	豬布林
猪灵蛮兵	豬布林蠻兵
掠夺者	掠奪者
玩家	玩家
北极熊	北極熊
药水	藥水
河豚	河豚
兔子	兔子
劫掠兽	劫毀獸
鲑鱼	鮭魚
绵羊	綿羊
潜影贝	界伏蚌
潜影弹	界伏彈
蠹虫	蠹魚
骷髅	骷髏
骷髅马	骷髏馬
史莱姆	史萊姆
小火球	小火球
嗅探兽	嗅探獸
雪傀儡	雪人
雪球	雪球
刷怪笼矿车	生怪磚礦車
光灵箭	追跡之箭
蜘蛛	蜘蛛
喷溅药水	飛濺藥水
云杉木船	杉木船
云杉木运输船	儲物箱杉木船
鱿鱼	魷魚
流浪者	流髑
炽足兽	熾足獸
蝌蚪	蝌蚪
文本展示实体	文字展示實體
被激活的TNT	點燃的 TNT
TNT矿车	TNT 礦車
行商羊驼	商駝
三叉戟	三叉戟
热带鱼	熱帶魚
海葵鱼	海葵魚
黑刺尾鲷	長鼻高鰭刺尾魚
镰鱼	角蝶魚
华丽蝴蝶鱼	華麗蝴蝶魚
鹦嘴鱼	鸚哥魚
额斑刺蝶鱼	額斑刺蝶魚
红丽鱼	赤慈鯛
红唇真蛇鳚	紅唇真蛇䲁
红边笛鲷	西大西洋笛鯛
马鲅	馬鮁
白条双锯鱼	白條雙鋸魚
鳞鲀	鱗魨
蓝刺尾鲷	擬刺尾鯛
高鳍鹦嘴鱼	高鰭鸚哥魚
黄刺尾鲷	黃高鰭刺尾魚
蝴蝶鱼	蝴蝶魚
丽鱼	慈鯛
小丑鱼	小丑魚
五彩搏鱼	五彩搏魚
绣雀鲷	紅黃繡雀鯛
川纹笛鲷	川紋笛鯛
拟羊鱼	鬚鯛
背蒂类	貝蒂魚
方身类	方塊魚
咸水类	鹽水魚
陶鱼类	黏土魚
速跃类	迅泳魚
飞翼类	翅翼魚
闪鳞类	閃魚
石首类	赤羚魚
窥伺类	藏礁魚
多斑类	斑點魚
条纹类	條紋魚
日纹类	日紋魚
海龟	海龜
恼鬼	惱鬼
村民	村民
盔甲匠	製甲師
屠夫	屠夫
制图师	製圖師
牧师	神職人員
农民	農夫
渔夫	漁夫
制箭师	製箭師
皮匠	皮匠
图书管理员	圖書管理員
石匠	石匠
傻子	傻子
牧羊人	牧羊人
工具匠	工具匠
武器匠	武器匠
卫道士	衛道士
流浪商人	流浪商人
监守者	伏守者
女巫	女巫
凋灵	凋零怪
凋灵骷髅	凋零骷髏
凋灵之首	凋零頭顱
狼	狼
僵尸疣猪兽	豬屍獸
僵尸	殭屍
僵尸马	殭屍馬
僵尸村民	殭屍村民
僵尸猪灵	殭屍化豬布林
无法召唤类型为%s的实体	無法召喚類型為 %s 的實體
袭击	突襲
失败	失敗
袭击 - 失败	突襲 - 失敗
剩余%s名袭击者	剩餘敵人：%s
胜利	勝利
袭击 - 胜利	突襲 - 勝利
藏宝图	藏寶圖
丛林探险家地图	叢林探險家地圖
沼泽探险家地图	沼澤探險家地圖
编号#%s	ID #%s
（等级 %s/%s）	（縮放等級 %s/%s）
已锁定	已鎖定
林地探险家地图	林地探險家地圖
海洋探险家地图	海洋探險家地圖
比例尺1:%s	比例尺 1:%s
试炼探险家地图	試煉探險家地圖
未知地图	未知的地圖
沙漠村庄地图	沙漠村莊地圖
平原村庄地图	平原村莊地圖
热带草原村庄地图	莽原村莊地圖
雪原村庄地图	雪原村莊地圖
针叶林村庄地图	針葉林村莊地圖
无底深渊	無底深淵
经典平坦	經典平坦
主世界	主世界
红石俱备	為紅石準備
雪之王国	雪之王國
挖掘工的梦想	隧道工人的夢想
水世界	水世界
???	???
冒险模式	冒險模式
你的游戏模式已被更新为%s	你的遊戲模式已被更新為 %s
创造模式	創造模式
极限模式	極限模式
旁观模式	旁觀者模式
生存模式	生存模式
允许火在远离玩家处蔓延	允許火在遠離玩家處蔓延
控制火和熔岩是否能够在距离任何玩家超过8个区块处蔓延	控制火和熔岩是否能在距離任何玩家 8 個區塊之外繼續蔓延
进度通知	進度通知
在方块交互爆炸中，一些方块不会掉落战利品	在與方塊互動的爆炸中，部分方塊不會掉落成戰利品
在与方块交互引起的爆炸中，部分被破坏方块的掉落物会被炸毁。	在與方塊相互作用引發的爆炸中，會遺失部分被摧毀方塊的掉落物。
掉落	掉落
杂项	雜項
生物	生物
生成	生成
世界更新	世界更新
广播命令方块输出	記錄指令方塊輸出
命令修改方块数量限制	指令修改方塊數量限制
单条命令（如fill和clone）最多能更改的方块数量	單個指令（例如 fill 或是 clone）最多能修改的方塊數量。
禁用鞘翅移动检测	停用鞘翅移動檢測
禁用玩家移动检测	停用玩家移動檢測
禁用袭击	停用突襲
游戏内时间流逝	日夜交替
非生物实体掉落	掉落實體裝備
控制矿车（包括内容物）、物品展示框、船等的物品掉落。	控制自礦車（包括物品欄）、物品展示框、船等的掉落物。
火焰蔓延	更新火焰
立即重生	立即重生
生成幻翼	生成夜魅
合成需要配方	需要配方才能合成
若启用，玩家只能使用已解锁的配方合成。	若啟用，玩家將只能合成已解鎖的配方。
生物战利品掉落	掉落生物戰利品
控制生物死亡后是否掉落资源，包括经验球。	控制生物資源掉落，包含經驗球。
生成生物	生成生物
一些实体可能有其特定的规则。	部分實體可能採用不同的規則。
生成灾厄巡逻队	生成掠奪者巡邏隊
方块掉落	掉落方塊
控制破坏方块后是否掉落资源，包括经验球。	控制方塊資源掉落，包含經驗球。
生成流浪商人	生成流浪商人
藤蔓蔓延	藤蔓蔓延
控制藤蔓方块是否会随机向相邻的方块蔓延。不会影响其他藤蔓类方块（例如垂泪藤和缠怨藤等）。	控制藤蔓方塊是否能隨機向相鄰的方塊蔓延。這不會影響其他類型的藤蔓方塊（例如垂泣藤及扭曲藤等）。
生成监守者	生成伏守者
天气更替	更新天氣
溺水伤害	造成溺水傷害
掷出的末影珍珠在死亡时消失	拋出的終界珍珠在死亡時消失
玩家投掷的末影珍珠是否在玩家死亡时消失。	玩家拋出的終界珍珠是否在玩家死亡時消失。
被骑乘的实体能否使用传送门	被騎乘的實體是否能使用傳送門
允许被骑乘的实体通过下界传送门、末地传送门和末地折跃门传送。	允許被騎乘的實體透過地獄傳送門、終界傳送門和終界折躍門傳送。
摔落伤害	造成摔落傷害
火焰伤害	造成火焰傷害
宽恕死亡玩家	原諒死者
愤怒的中立生物将在其目标玩家于附近死亡后息怒。	當目標玩家在附近死亡後，被其激怒的中立生物將息怒。
冰冻伤害	造成冰凍傷害
全局声音事件	全域聲音事件
特定游戏事件（如Boss生成）发生时，声音可在所有地方听见。	當特定遊戲事件發生時，例如生成 Boss，聲音可以在任何地方被聽見。
死亡后保留物品栏	死亡後保留物品欄
允许流动熔岩转化为熔岩源	流動熔岩轉化成熔岩源
流动熔岩在两面与熔岩源相邻时转化为熔岩源。	流動熔岩在被兩個熔岩源包圍時，會轉化成熔岩源。
启用玩家定位栏	啟用玩家定位條
启用后，屏幕上会显示指示玩家方位的定位栏。	啟用後，畫面上會顯示指示玩家方位的定位條。
通告管理员命令	記錄管理員指令
命令连锁执行数量限制	指令連鎖大小限制
应用于命令方块链和函数。	套用於連鎖型指令方塊及函數。
命令上下文数量限制	指令的上下文上限
“execute as”等命令可以使用的上下文数量最大值。	「execute as」等指令使用的上下文最大數量。
实体挤压上限	實體擠壓上限
矿车最大速度	礦車最大速度
矿车在地面上移动的默认最大速度。	礦車在地面上移動的預設速度上限。
在生物爆炸中，一些方块不会掉落战利品	在生物的爆炸中，部分方塊不會掉落成戰利品
在生物引起的爆炸中，部分被破坏方块的掉落物会被炸毁。	在生物引發的爆炸中，會遺失部分被摧毀方塊的掉落物。
允许破坏性生物行为	允許生物的破壞行為
生命值自然恢复	自然回血
创造模式下玩家在下界传送门中等待的时间	創造模式玩家使用地獄傳送門的等待時間
创造模式下的玩家通过下界传送门前往其他维度前需要站在其中等待的时间（以刻为单位）。	創造模式玩家使用地獄傳送門前往其他維度前，需要站在其中的等待時間（以刻為單位）。
非创造模式下玩家在下界传送门中等待的时间	非創造模式玩家使用地獄傳送門的等待時間
非创造模式下的玩家通过下界传送门前往其他维度前需要站在其中等待的时间（以刻为单位）。	非創造模式玩家使用地獄傳送門前往其他維度前，需要站在其中的等待時間（以刻為單位）。
入睡占比	睡眠比例
跳过夜晚所需的入睡玩家占比。	跳過夜晚所需的入睡玩家比例。
弹射物能否破坏方块	投射物是否能破壞方塊
控制弹射物是否能破坏可被其破坏的方块。	控制投射物是否能破壞可被其破壞的方塊。
随机刻速率	隨機刻速率
简化调试信息	簡化除錯資訊
限制调试屏幕内容。	限制除錯畫面的內容。
发送命令反馈	回傳指令回饋
显示死亡消息	顯示死亡訊息
积雪厚度	積雪厚度
降雪时，地面上的雪最多堆积到此处指定的层数。	降雪時，地面上的積雪最多累積至此處指定的層數。
出生区块半径	重生區塊半徑
主世界出生点周围保持加载的区块数量。	主世界重生點周圍維持載入的區塊數量。
重生点半径	重生點半徑
控制适合玩家生成的出生点周围区域大小。	控制玩家能夠生成的重生點範圍區域大小。
允许旁观者生成地形	允許旁觀者生成地形
允许TNT被点燃并爆炸	允許 TNT 被點燃並爆炸
在TNT爆炸中，一些方块不会掉落战利品	在 TNT 的爆炸中，部分方塊不會掉落成戰利品
在TNT引起的爆炸中，部分被破坏方块的掉落物会被炸毁。	在 TNT 引發的爆炸中，會遺失部分被摧毀方塊的掉落物。
无差别愤怒	無差別憤怒
愤怒的中立生物将攻击附近的所有玩家，而不再限于激怒它们的玩家。禁用“宽恕死亡玩家”可达到最佳效果。	被激怒的中立生物將攻擊任何附近的玩家，而不限於激怒他們的那位。停用「forgiveDeadPlayers」可以有更好的效果。
允许流动水转化为水源	流動水轉化成水源
流动水在两面与水源相邻时转化为水源。	流動水在被兩個水源包圍時，會轉化成水源。
自定义	自訂
旧版自定义	舊版自訂
放大化	巨大化世界
注意：仅供娱乐！需要强劲的电脑。	注意：這只是為了好玩，需要效能良好的電腦。
调试模式	除錯模式
超平坦	超平坦
巨型生物群系	大型生態域
单一生物群系	單一生態域
洞穴	洞穴
浮岛	浮空島嶼
提交此举报，即代表你确认你提供的信息已尽可能准确和完整。	提交這份檢舉，即表示您已確認提供了盡可能準確且完整的資訊。
留言	留言
提供详情可以帮助我们更严谨地做出决定。	分享詳細資料有助我們做出更準確、清楚的判斷。
如果离开，该举报及留言将不会被保留。\n确定要离开吗？	如果離開，這份檢舉和留言將會遺失。\n您確定仍要離開嗎？
离开并放弃举报	離開並捨棄檢舉
保存为草稿	儲存為草稿
继续编辑	繼續編輯
放弃举报和留言？	捨棄檢舉和留言？
继续编辑现有举报还是放弃并新建另一份举报？	您是要繼續編輯現有的檢舉報告，還是要捨棄並建立新報告？
放弃	捨棄
继续编辑还是放弃？	您要繼續編輯或是捨棄？
该聊天举报草稿将在退出时丢失	您有一份聊天訊息檢舉草稿，如果離開，將遺失您的草稿
编辑聊天举报草稿？	是否編輯聊天訊息檢舉草稿？
发送举报时出现问题	提交檢舉時發生問題
你在哪里观察到了不良行为？\n这有助于我们调查你的案例。	您在哪裡觀察到不當行為？\n這有助於我們調查您所提交的個案。
请描述发生的状况：	請說明事情經過：
请描述举报该名称的理由：	請說明你檢舉這個名稱的原因：
正在举报“%s”。	您正在檢舉 "%s"。
举报玩家名称	檢舉不當玩家名稱
你为什么要举报？	請說明檢舉理由。
了解举报功能	深入了解檢舉機制
吸毒或饮酒	毒品或酒精
有人教唆他人涉毒或教唆未成年人饮酒。	有人鼓勵他人參與非法用藥行為，或唆使未達法規年齡者飲酒。
对儿童的性剥削或虐待	兒童性剝削或虐待
有人谈论或以其他方式宣扬涉及儿童的不当行为。	有人談論或以其他方式推廣涉及孩童的猥褻行為。
诽谤	誹謗
有人以利用或误导他人为目的，正在损害你或他人的名誉，例如散布虚假信息。	有人以利用或誤導他人為目的，損害你或他人的名譽，例如散布虛假資訊。
描述：	描述：
不实举报	不實檢舉
我想举报该玩家	我想要檢舉此玩家
该玩家使我恼怒或做的事情使我反感。	此玩家的行為使我惱怒或反感。
骚扰或霸凌	騷擾或霸凌
有人羞辱、攻击、霸凌你或其他人。这包括在未经允许的情况下不断尝试联系你或其他人，或发布你或其他人的隐私信息。	有人羞辱、攻擊、霸凌你或其他人。包含違反您或其他人意願，不斷聯絡騷擾或是散布個人資料（即「肉搜」）。
仇恨言论	仇恨言論
有人因身份要素（如宗教信仰、种族或性相关）攻击你或其他玩家。	有人基於身分（如宗教、種族或性相關）攻擊您或其他玩家。
威胁伤害他人	恐嚇加害他人
有人威胁要在现实生活中伤害你或其他人。	有人恐嚇會在現實生活中加害您或其他人。
未经同意发布私密图像	未經同意的親密圖像
有人谈论、分享私密或亲密的图像，或以其他方式宣扬有关行为。	有人談論、分享或以其他方式推廣私密、親密的影像。
自残或自杀	自殘或自殺
有人威胁要自残或谈论现实生活中的自残行为。	有人談論或威脅要在現實生活中自殘。
性相关不当内容	性相關不當內容
皮肤图案与性行为、性器官和性暴力相关。	外觀圖案與性行為、性器官和性暴力有關。
恐怖主义或暴力极端主义	恐怖主義或暴力極端主義
有人因政治、宗教、意识形态或其他原因，谈论、宣扬、威胁实施恐怖主义或极端暴力行为。	有人因為政治、宗教、思想等其他原因，談論、推廣或威脅實行恐怖主義或極端暴力。
选择举报类型	選擇檢舉類別
我们已经成功收到你的举报。非常感谢！\n\n我们的团队将尽快进行审核。	謝謝，您已成功向我們提出檢舉！\n\n我們的團隊將會儘快進行審核。
发送举报	提交檢舉
请缩短留言	請縮短留言
发送举报时返回了错误：\n“%s”	提交檢舉時回傳了錯誤：\n「%s」
发送举报时遇到意外错误。	提交檢舉時發生了非預期的錯誤。
发送举报时发生了意外的HTTP错误。	提交檢舉時發生了非預期的 HTTP 錯誤。
发送举报时遇到了格式错误的负载。	提交檢舉時遭遇格式錯誤的訊息承載。
请选择举报类型	請選擇檢舉類別
请先阅读上方文本并勾选复选框后，再发送举报	請先閱讀上方文字並勾選核取方塊後，再提交檢舉
无法使用举报服务。请检查是否已联网，然后重试。	無法存取檢舉服務。請檢查您是否已連上網路，並重新嘗試。
发送举报中…	正在提交您的檢舉...
举报已发送	已送出檢舉
举报玩家皮肤	檢舉玩家外觀
举报玩家	檢舉玩家
聊天消息	聊天訊息
玩家名称	玩家名稱
玩家皮肤	玩家外觀
了解	了解
进度	進度
全部	全部
%s\n\n%s\n\n点击以下链接了解更多：%s	%s\n\n%s\n\n透過以下連結了解更多：%s
你的账户已被永久封禁，无法进行在线游戏或加入Realms。	您的帳號已被永久封鎖，您無法在線上模式遊玩或加入 Realms。
我们最近收到举报称你的账户存在不良行为。我们的监督员已审核你的案件并将其认定为%s，这违反了Minecraft社区准则。	我們最近收到了對您不當行為的檢舉。我們的仲裁者已審查此案並認定為「%s」，已違反 Minecraft 社群準則。
代码：%s	代碼：%s
代码：%s - %s	代碼：%s - %s
%s期限结束前，你无法进行在线游戏或加入Realms。	%s 在此之前，您無法使用線上模式或加入 Realms。
你的账户已被暂时封禁并将于%s后解封。	您的帳號已被暫時停權，將於 %s 後恢復。
我们最近收到举报称你的账户存在不良行为。我们的监督员已审核你的案件并认定你违反了Minecraft社区准则。	我們最近收到了對您不當行為的檢舉。我們的仲裁者已審查此案，並認定其違反 Minecraft 社群準則。
你当前的名称（“%s”）违反了我们的社区准则。你可以进行单人游戏，但需要更改名称才能进行在线游戏。\n\n通过以下链接了解更多或提交案件审查：%s	你現在使用的名稱（%s）違反社群準則。你可以遊玩單人遊戲，但你需要更改你的名稱以遊玩線上遊戲。\n\n前往以下連結以了解更多或提交個案複查：%s
多人游戏中不允许使用当前名称	在多人遊戲中不允許使用該名稱
假冒或分享信息以利用或误导他人	假冒或分享資訊以利用或誤導他人
推销非法药品	推銷非法藥品
描述现实生活中过度暴力或血腥的场面	描述現實世界的暴力或血腥場面
过多虚假或不实举报	過多虛假或不實檢舉
欺骗性获取或使用内容	欺騙行為以獲得或使用內容
违反社区准则	違反社群準則
有针对性地、有害地使用辱骂性语言	具針對性、有害地使用侮辱性語言
仇恨或歧视言论	仇恨或歧視言論
推广仇恨群体、恐怖组织或不法分子	推廣仇恨團體、恐怖組織或不法分子
意图在现实生活中造成人身或财产伤害	意圖在現實世界中造成人身或財產傷害
展示淫秽或色情材料	展示淫穢或色情材料
性相关话题或内容	性相關話題或內容
滥发消息或广告宣传	濫發訊息或廣告宣傳
你当前的皮肤违反了我们的社区准则。你仍然可以使用默认皮肤，或者选择新皮肤进行游戏。\n\n通过以下链接了解更多或提交案件审查：%s	你現在使用的外觀違反社群準則。你可以使用預設外觀，或是使用一個新的外觀遊玩。\n\n前往以下連結以了解更多或提交個案複查：%s
当前皮肤不允许使用	該外觀不被允許使用
账户已被永久封禁	帳號已被永久封鎖
账户已被暂时封禁	帳號已暫時停權
取消	取消
你有一份聊天举报草稿将在退出时丢失	您有一份聊天訊息檢舉草稿，如果離開，將遺失您的草稿
我们已经成功收到你的举报。非常感谢！\n\n我们的团队会尽快进行审核。	謝謝，您已成功向我們提出檢舉！\n\n我們的團隊將會儘快進行審核。
选择要举报的聊天消息	選擇要檢舉的聊天訊息
已选中%s条要举报的聊天消息	已選取 %s 則待檢舉訊息
请选择至少一条要举报的聊天消息	請選擇至少一則要檢舉的聊天訊息
举报中包含的消息过多	嘗試在檢舉中選取過多訊息
举报玩家聊天	檢舉玩家聊天
所选消息前后的部分消息将会用于提供额外的辅助信息	本訊息前後的其他訊息將會被採用，並作為額外的對話情境資訊使用
已隐藏%s条消息	已隱藏 %s 則訊息
%s加入了聊天	%s 加入了聊天
%1$s在%3$s说：%2$s	%1$s 在 %3$s 說：%2$s
已选中%s条消息，共%s条	已選取 %2$s 則中的 %1$s 則訊息
继续	繼續
复制链接到剪贴板	複製連結到剪貼簿
%s天	%s 天
向下	下
类型：%s	類型：%s
拒绝了%s个文件	已拒絕 %s 個檔案
添加文件失败	無法新增檔案
%s小时	%s 小時
正在加载Minecraft	正在載入 Minecraft
%s分钟	%s 分鐘
%s按钮	%s 按鈕
%s编辑框：%s	%s 編輯欄：%s
%s滑块	%s 滑桿
%s标签页	%s 頁籤
否	否
无	無
确定	確定
打开报告目录	開啟報告資料夾
单击鼠标右键获取更多信息	按下右鍵以查看更多
搜索…	搜尋...
显示全部	已列出所有項目
仅显示可冶炼	已列出高爐可熔煉項目
仅显示可合成	已列出可合成項目
仅显示可烧炼	已列出可熔煉項目
仅显示可熏制	已列出可燻製項目
向服务器报告	向伺服器回報
使用Microsoft账户管理	以 Microsoft 帳號管理
未屏蔽任何玩家的聊天消息	聊天室中沒有已封鎖的玩家
未隐藏任何玩家的聊天消息	聊天室中沒有被隱藏的玩家
%s的聊天消息将会被隐藏	將會隱藏 %s 的聊天訊息
在聊天中隐藏	在聊天室中隱藏
隐藏%s发送的消息	隱藏來自 %s 的訊息
举报玩家%s	檢舉玩家 %s
显示%s发送的消息	顯示來自 %s 的訊息
举报	檢舉
未找到使用此名称的玩家	找不到使用此名稱的玩家
%s - %s名玩家	%s - %s 位玩家
在聊天中显示	在聊天室中顯示
%s的聊天消息将会被显示	將會顯示 %s 的聊天訊息
已屏蔽	已封鎖
已屏蔽 - 离线	已封鎖 - 離線
隐藏	隱藏
隐藏 - 离线	隱藏 - 離線
离线	離線
已隐藏	隱藏
社交	社群交流
隐藏消息	隱藏訊息
举报服务不可用	檢舉服務目前無法使用
玩家%s没有可举报的消息	玩家 %s 沒有可以檢舉的訊息
无法举报该玩家，服务器无法验证其聊天消息。	無法檢舉此玩家，因為此伺服器無法驗證該玩家的聊天訊息
显示消息	顯示訊息
统计信息	統計
返回到服务器列表	返回伺服器清單
返回到Realm列表	返回 Realms 清單
返回到标题屏幕	返回標題畫面
返回到世界列表	返回世界清單
点击以禁用槽位	按此停用欄位
向上	上
返回（%s秒）	返回（%s 秒）
正在等待服务器响应	正在等待伺服器回應
是	是
编辑悬挂式告示牌消息	編輯懸掛式告示牌訊息
仰慕	仰慕
呼唤	呼喚
想象	夢想
感受	感覺
沉思	沉思
寻觅	尋覓
歌颂	歌頌
憧憬	嚮往
摧毁物品	銷毀物品
用%1$s+%2$s来保存快捷栏	按下 %1$s + %2$s 儲存快捷欄
已保存物品快捷栏（用%1$s+%2$s来加载）	快捷欄已儲存（按 %1$s + %2$s 復原）
能破坏：	可破壞：
可以放在：	可置於：
未知	未知
颜色：%s	顏色：%s
%s个组件	%s 個元件
已禁用物品	已停用的物品
耐久度：%s / %s	耐久度：%s / %s
已染色	已染色
悦灵刷怪蛋	悅靈 生怪蛋
紫水晶碎片	紫水晶碎片
垂钓纹样陶片	垂釣陶器碎片
苹果	蘋果
弓箭纹样陶片	弓箭陶器碎片
犰狳鳞甲	犰狳鱗甲
犰狳刷怪蛋	犰狳 生怪蛋
举臂纹样陶片	人形陶器碎片
美西螈桶	六角恐龍桶
美西螈刷怪蛋	六角恐龍 生怪蛋
烤马铃薯	烤馬鈴薯
蝙蝠刷怪蛋	蝙蝠 生怪蛋
蜜蜂刷怪蛋	蜜蜂 生怪蛋
生牛肉	生牛肉
甜菜种子	甜菜種子
甜菜汤	甜菜湯
黑色收纳袋	黑色束口袋
黑色染料	黑色染料
黑色挽具	黑色帽鞍
利刃纹样陶片	利刃陶器碎片
烈焰粉	烈焰粉
烈焰棒	烈焰桿
烈焰人刷怪蛋	烈焰使者 生怪蛋
蓝色收纳袋	藍色束口袋
蓝色染料	藍色染料
蓝色鸡蛋	藍色雞蛋
蓝色挽具	藍色帽鞍
沼骸刷怪蛋	沼骸 生怪蛋
锻造模板	鍛造模板
镶铆盔甲纹饰	鑲鉚盔甲紋樣
骨头	骨頭
骨粉	骨粉
书	書
波纹边旗帜图案	鋸齒框邊旗幟圖案
弓	弓
碗	碗
面包	麵包
旋风棒	旋風桿
旋风人刷怪蛋	旋風使者 生怪蛋
佳酿纹样陶片	釀造陶器碎片
红砖	紅磚頭
棕色收纳袋	棕色束口袋
棕色染料	棕色染料
棕色鸡蛋	棕色雞蛋
棕色挽具	棕色帽鞍
刷子	刷子
铁桶	鐵桶
空	空
可容纳一组混合的物品	可容納一組混合的物品
满	滿
烈焰纹样陶片	烈焰陶器碎片
骆驼刷怪蛋	駱駝 生怪蛋
胡萝卜钓竿	胡蘿蔔釣竿
猫刷怪蛋	貓 生怪蛋
洞穴蜘蛛刷怪蛋	洞穴蜘蛛 生怪蛋
锁链靴子	鎖鏈靴子
锁链胸甲	鎖鏈胸甲
锁链头盔	鎖鏈頭盔
锁链护腿	鎖鏈護腿
木炭	木炭
生鸡肉	生雞肉
鸡刷怪蛋	雞 生怪蛋
紫颂果	歌萊果
黏土球	黏土球
时钟	時鐘
煤炭	煤炭
海岸盔甲纹饰	海岸盔甲紋樣
可可豆	可可豆
生鳕鱼	生鱈魚
鳕鱼桶	鱈魚桶
鳕鱼刷怪蛋	鱈魚 生怪蛋
指南针	羅盤
牛排	牛排
熟鸡肉	烤雞
熟鳕鱼	烤鱈魚
熟羊肉	烤羊肉
熟猪排	烤豬肉
熟兔肉	烤兔肉
熟鲑鱼	烤鮭魚
曲奇	餅乾
铜斧	銅斧
铜靴子	銅製靴子
铜胸甲	銅製胸甲
铜傀儡刷怪蛋	銅魔像 生怪蛋
铜头盔	銅製頭盔
铜锄	銅鋤
铜马铠	銅製馬鎧
铜锭	銅錠
铜护腿	銅製護腿
铜粒	銅粒
铜镐	銅鎬
铜锹	銅鏟
铜剑	銅劍
牛刷怪蛋	牛 生怪蛋
嘎枝刷怪蛋	嘎枝 生怪蛋
旗帜图案	旗幟圖案
苦力怕盾徽	苦力怕圖紋
苦力怕盾徽旗帜图案	苦力怕圖紋旗幟圖案
苦力怕刷怪蛋	苦力怕 生怪蛋
弩	弩
弹射物：	投射物：
弹射物：%s × %s	投射物：%s × %s
弹射物：%s	投射物：%s
青色收纳袋	青色束口袋
青色染料	青色染料
青色挽具	青色帽鞍
危机纹样陶片	危機陶器碎片
调试棒	除錯棒
%s不具备属性	%s 沒有屬性
已选择“%s”（%s）	選擇 "%s" (%s)
“%s”设为%s	"%s" to %s
钻石	鑽石
钻石斧	鑽石斧
钻石靴子	鑽石靴子
钻石胸甲	鑽石胸甲
钻石头盔	鑽石頭盔
钻石锄	鑽石鋤
钻石马铠	鑽石製馬鎧
钻石护腿	鑽石護腿
钻石镐	鑽石鎬
钻石锹	鑽石鏟
钻石剑	鑽石劍
唱片残片	唱片碎片
音乐唱片 - 5	唱片 - 5
海豚刷怪蛋	海豚 生怪蛋
驴刷怪蛋	驢子 生怪蛋
龙息	龍之吐息
干海带	海帶乾
溺尸刷怪蛋	沉屍 生怪蛋
沙丘盔甲纹饰	沙丘盔甲紋樣
回响碎片	回聲碎片
鸡蛋	雞蛋
远古守卫者刷怪蛋	遠古深海守衛 生怪蛋
鞘翅	鞘翅
绿宝石	綠寶石
附魔书	附魔書
附魔金苹果	附魔金蘋果
末影龙刷怪蛋	終界龍 生怪蛋
末影珍珠	終界珍珠
末影人刷怪蛋	終界使者 生怪蛋
末影螨刷怪蛋	終界蟎 生怪蛋
唤魔者刷怪蛋	喚魔者 生怪蛋
附魔之瓶	經驗瓶
探险纹样陶片	探險陶器碎片
眼眸盔甲纹饰	眼眸盔甲紋樣
羽毛	羽毛
发酵蛛眼	發酵蜘蛛眼
砖纹旗帜图案	磚牆花紋旗幟圖案
地图	地圖
火焰弹	火焰彈
飞行时间：	飛行時間：
%s × %s	%s × %s
烟火之星	火藥球
淡化至	淡出
闪烁	閃爍
未知形状	未知形狀
喷发状	爆裂
苦力怕状	苦力怕形
大型球状	大型球狀
小型球状	小型球狀
星形	星形
踪迹	軌跡
钓鱼竿	釣竿
燧石	燧石
打火石	打火石
涡流盔甲纹饰	渦流盔甲紋樣
涡流	渦流
涡流旗帜图案	渦流旗幟圖案
涡流纹样陶片	渦流陶器碎片
花朵盾徽	花朵圖紋
花朵盾徽旗帜图案	花朵圖紋旗幟圖案
狐狸刷怪蛋	狐狸 生怪蛋
挚友纹样陶片	摯友陶器碎片
青蛙刷怪蛋	青蛙 生怪蛋
恶魂刷怪蛋	地獄幽靈 生怪蛋
恶魂之泪	幽靈之淚
玻璃瓶	玻璃瓶
闪烁的西瓜片	鑲金西瓜片
地球	地球
地球旗帜图案	地球旗幟圖案
发光浆果	螢光莓
荧光墨囊	螢光墨囊
发光鱿鱼刷怪蛋	螢光魷魚 生怪蛋
荧石粉	螢石粉
山羊角	山羊角
山羊刷怪蛋	山羊 生怪蛋
金锭	金錠
金粒	金粒
金苹果	金蘋果
金斧	金斧
金靴子	黃金靴子
金胡萝卜	金胡蘿蔔
金胸甲	黃金胸甲
金头盔	黃金頭盔
金锄	金鋤
金马铠	黃金製馬鎧
金护腿	黃金護腿
金镐	金鎬
金锹	金鏟
金剑	金劍
灰色收纳袋	灰色束口袋
灰色染料	灰色染料
灰色挽具	灰色帽鞍
绿色收纳袋	綠色束口袋
绿色染料	綠色染料
绿色挽具	綠色帽鞍
守卫者刷怪蛋	深海守衛 生怪蛋
火药	火藥
旋风	狂風
旋风旗帜图案	狂風旗幟圖案
旋风纹样陶片	狂風陶器碎片
快乐恶魂刷怪蛋	快樂幽靈 生怪蛋
挽具	帽鞍
海洋之心	海洋之心
爱心纹样陶片	愛心陶器碎片
心碎纹样陶片	心碎陶器碎片
疣猪兽刷怪蛋	豬布獸 生怪蛋
蜂蜜瓶	蜂蜜瓶
蜜脾	蜂巢
马刷怪蛋	馬 生怪蛋
雇主盔甲纹饰	主人盔甲紋樣
狼嚎纹样陶片	狼嚎陶器碎片
尸壳刷怪蛋	屍殼 生怪蛋
墨囊	墨囊
铁斧	鐵斧
铁靴子	鐵製靴子
铁胸甲	鐵製胸甲
铁傀儡刷怪蛋	鐵魔像 生怪蛋
铁头盔	鐵製頭盔
铁锄	鐵鋤
铁马铠	鐵製馬鎧
铁锭	鐵錠
铁护腿	鐵製護腿
铁粒	鐵粒
铁镐	鐵鎬
铁锹	鐵鏟
铁剑	鐵劍
知识之书	知識之書
青金石	青金石
熔岩桶	熔岩桶
拴绳	拴繩
皮革	皮革
皮革靴子	皮革靴子
皮革外套	皮革上衣
皮革帽子	皮革帽子
皮革马铠	皮革製馬鎧
皮革裤子	皮革褲子
淡蓝色收纳袋	淺藍色束口袋
淡蓝色染料	淺藍色染料
淡蓝色挽具	淺藍色帽鞍
淡灰色收纳袋	淺灰色束口袋
淡灰色染料	淺灰色染料
淡灰色挽具	淺灰色帽鞍
黄绿色收纳袋	淺綠色束口袋
黄绿色染料	淺綠色染料
黄绿色挽具	淺綠色帽鞍
滞留型粗制的药水	滯留 基礎藥水
不可合成的滞留型药水	滯留 不可合成的藥水
滞留型抗火药水	滯留 抗火藥水
滞留型伤害药水	滯留 傷害藥水
滞留型治疗药水	滯留 治療藥水
滞留型虫蚀药水	滯留 蛀蝕藥水
滞留型隐身药水	滯留 隱形藥水
滞留型跳跃药水	滯留 跳躍藥水
滞留型飘浮药水	滯留 懸浮藥水
滞留型幸运药水	滯留 幸運藥水
滞留型平凡的药水	滯留 平凡藥水
滞留型夜视药水	滯留 夜視藥水
滞留型渗浆药水	滯留 滲漿藥水
滞留型剧毒药水	滯留 劇毒藥水
滞留型再生药水	滯留 回復藥水
滞留型缓降药水	滯留 緩降藥水
滞留型迟缓药水	滯留 緩速藥水
滞留型力量药水	滯留 力量藥水
滞留型迅捷药水	滯留 迅捷藥水
滞留型浓稠的药水	滯留 黏稠藥水
滞留型神龟药水	滯留 龜仙藥水
滞留型水瓶	滯留 水瓶
滞留型水肺药水	滯留 水下呼吸藥水
滞留型虚弱药水	滯留 虛弱藥水
滞留型盘丝药水	滯留 結網藥水
滞留型蓄风药水	滯留 蘊風藥水
羊驼刷怪蛋	駱馬 生怪蛋
磁石指针	磁石羅盤
重锤	重錘
品红色收纳袋	洋紅色束口袋
品红色染料	洋紅色染料
品红色挽具	洋紅色帽鞍
岩浆膏	岩漿球
岩浆怪刷怪蛋	岩漿立方怪 生怪蛋
空地图	空白地圖
西瓜种子	西瓜種子
西瓜片	西瓜片
奶桶	鮮奶桶
采矿纹样陶片	礦工陶器碎片
Mojang徽标	Mojang 圖紋
Mojang徽标旗帜图案	Mojang 標誌旗幟圖案
哞菇刷怪蛋	哞菇 生怪蛋
悲恸纹样陶片	悼惜陶器碎片
骡刷怪蛋	騾子 生怪蛋
蘑菇煲	蘑菇湯
音乐唱片	唱片
C418 - 11	C418 - 11
C418 - 13	C418 - 13
Samuel Åberg - 5	Samuel Åberg - 5
C418 - blocks	C418 - blocks
C418 - cat	C418 - cat
C418 - chirp	C418 - chirp
Lena Raine - Creator	Lena Raine - Creator
Lena Raine - Creator（八音盒）	Lena Raine - Creator（音樂盒）
C418 - far	C418 - far
Hyper Potions - Lava Chicken	Hyper Potions - Lava Chicken
C418 - mall	C418 - mall
C418 - mellohi	C418 - mellohi
Lena Raine - otherside	Lena Raine - otherside
Lena Raine - Pigstep	Lena Raine - Pigstep
Aaron Cherof - Precipice	Aaron Cherof - Precipice
Aaron Cherof - Relic	Aaron Cherof - Relic
C418 - stal	C418 - stal
C418 - strad	C418 - strad
Amos Roddy - Tears	Amos Roddy - Tears
C418 - wait	C418 - wait
C418 - ward	C418 - ward
生羊肉	生羊肉
命名牌	命名牌
鹦鹉螺壳	鸚鵡螺殼
下界砖	地獄磚頭
下界之星	地獄之星
下界合金斧	獄髓斧
下界合金靴子	獄髓靴子
下界合金胸甲	獄髓胸甲
下界合金头盔	獄髓頭盔
下界合金锄	獄髓鋤
下界合金锭	獄髓錠
下界合金护腿	獄髓護腿
下界合金镐	獄髓鎬
下界合金碎片	獄髓碎片
下界合金锹	獄髓鏟
下界合金剑	獄髓劍
下界合金升级	獄髓升級
豹猫刷怪蛋	山貓 生怪蛋
不祥之瓶	不祥之瓶
不祥试炼钥匙	不祥試煉鑰匙
橙色收纳袋	橙色束口袋
橙色染料	橙色染料
橙色挽具	橙色帽鞍
熊猫刷怪蛋	貓熊 生怪蛋
纸	紙
鹦鹉刷怪蛋	鸚鵡 生怪蛋
幻翼膜	夜魅皮膜
幻翼刷怪蛋	夜魅 生怪蛋
猪刷怪蛋	豬 生怪蛋
猪鼻	豬鼻
猪鼻旗帜图案	豬鼻旗幟圖案
猪灵蛮兵刷怪蛋	豬布林蠻兵 生怪蛋
猪灵刷怪蛋	豬布林 生怪蛋
掠夺者刷怪蛋	掠奪者 生怪蛋
粉红色收纳袋	粉紅色束口袋
粉红色染料	粉紅色染料
粉红色挽具	粉紅色帽鞍
瓶子草荚果	瓶子草豆莢
富饶纹样陶片	富饒陶器碎片
毒马铃薯	毒馬鈴薯
北极熊刷怪蛋	北極熊 生怪蛋
爆裂紫颂果	爆開的歌萊果
生猪排	生豬肉
粗制的药水	基礎藥水
不可合成的药水	不可合成的藥水
抗火药水	抗火藥水
伤害药水	傷害藥水
治疗药水	治療藥水
虫蚀药水	蛀蝕藥水
隐身药水	隱形藥水
跳跃药水	跳躍藥水
飘浮药水	懸浮藥水
幸运药水	幸運藥水
平凡的药水	平凡藥水
夜视药水	夜視藥水
渗浆药水	滲漿藥水
剧毒药水	劇毒藥水
再生药水	回復藥水
缓降药水	緩降藥水
迟缓药水	緩速藥水
力量药水	力量藥水
迅捷药水	迅捷藥水
浓稠的药水	黏稠藥水
神龟药水	龜仙藥水
水瓶	水瓶
水肺药水	水下呼吸藥水
虚弱药水	虛弱藥水
盘丝药水	結網藥水
蓄风药水	蘊風藥水
珍宝纹样陶片	珍寶陶器碎片
头颅纹样陶片	頭顱陶器碎片
细雪桶	粉雪桶
海晶砂粒	海磷晶體
海晶碎片	海磷碎片
河豚桶	河豚桶
河豚刷怪蛋	河豚 生怪蛋
南瓜派	南瓜派
南瓜种子	南瓜種子
紫色收纳袋	紫色束口袋
紫色染料	紫色染料
紫色挽具	紫色帽鞍
下界石英	地獄石英
生兔肉	生兔肉
兔子脚	兔子腳
兔子皮	兔子皮
兔子刷怪蛋	兔子 生怪蛋
兔肉煲	兔肉湯
牧民盔甲纹饰	牧者盔甲紋樣
劫掠兽刷怪蛋	劫毀獸 生怪蛋
粗铜	銅原礦
粗金	金原礦
粗铁	鐵原礦
追溯指针	回生羅盤
红色收纳袋	紅色束口袋
红色染料	紅色染料
红色挽具	紅色帽鞍
红石粉	紅石粉
树脂砖	樹脂磚頭
肋骨盔甲纹饰	肋骨盔甲紋樣
腐肉	腐肉
鞍	鞍
生鲑鱼	生鮭魚
鲑鱼桶	鮭魚桶
鲑鱼刷怪蛋	鮭魚 生怪蛋
刮削纹样陶片	刮削陶器碎片
鳞甲	鱗甲
哨兵盔甲纹饰	哨兵盔甲紋樣
塑造盔甲纹饰	工匠盔甲紋樣
麦捆纹样陶片	麥捆陶器碎片
剪刀	剪刀
绵羊刷怪蛋	綿羊 生怪蛋
树荫纹样陶片	樹蔭陶器碎片
盾牌	盾牌
黑色盾牌	黑色盾牌
蓝色盾牌	藍色盾牌
棕色盾牌	棕色盾牌
青色盾牌	青色盾牌
灰色盾牌	灰色盾牌
绿色盾牌	綠色盾牌
淡蓝色盾牌	淺藍色盾牌
淡灰色盾牌	淺灰色盾牌
黄绿色盾牌	淺綠色盾牌
品红色盾牌	洋紅色盾牌
橙色盾牌	橙色盾牌
粉红色盾牌	粉紅色盾牌
紫色盾牌	紫色盾牌
红色盾牌	紅色盾牌
白色盾牌	白色盾牌
黄色盾牌	黃色盾牌
潜影壳	界伏殼
潜影贝刷怪蛋	界伏蚌 生怪蛋
告示牌	告示牌
幽静盔甲纹饰	寂靜盔甲紋樣
蠹虫刷怪蛋	蠹魚 生怪蛋
骷髅马刷怪蛋	骷髏馬 生怪蛋
骷髅刷怪蛋	骷髏 生怪蛋
头颅盾徽	骷髏圖紋
头颅盾徽旗帜图案	骷髏圖紋旗幟圖案
黏液球	史萊姆球
史莱姆刷怪蛋	史萊姆 生怪蛋
可应用于：	可套用在：
放入锭或晶体	放置錠或晶體
盔甲	盔甲
放入盔甲	放置盔甲
锭或晶体	錠或晶體
所需原材料：	原材料：
放入下界合金锭	放置獄髓錠
钻石装备	鑽石裝備
放入钻石盔甲、武器或工具	放置鑽石盔甲、武器或工具
已有升级：	已有升級：
嗅探兽刷怪蛋	嗅探獸 生怪蛋
嗅探纹样陶片	嗅探陶器碎片
猪鼻盔甲纹饰	豬鼻盔甲紋樣
雪傀儡刷怪蛋	雪人 生怪蛋
蜘蛛眼	蜘蛛眼
蜘蛛刷怪蛋	蜘蛛 生怪蛋
尖塔盔甲纹饰	旋塔盔甲紋樣
喷溅型粗制的药水	飛濺 基礎藥水
不可合成的喷溅型药水	飛濺 不可合成的藥水
喷溅型抗火药水	飛濺 抗火藥水
喷溅型伤害药水	飛濺 傷害藥水
喷溅型治疗药水	飛濺 治療藥水
喷溅型虫蚀药水	飛濺 蛀蝕藥水
喷溅型隐身药水	飛濺 隱形藥水
喷溅型跳跃药水	飛濺 跳躍藥水
喷溅型飘浮药水	飛濺 懸浮藥水
喷溅型幸运药水	飛濺 幸運藥水
喷溅型平凡的药水	飛濺 平凡藥水
喷溅型夜视药水	飛濺 夜視藥水
喷溅型渗浆药水	飛濺 滲漿藥水
喷溅型剧毒药水	飛濺 劇毒藥水
喷溅型再生药水	飛濺 回復藥水
喷溅型缓降药水	飛濺 緩降藥水
喷溅型迟缓药水	飛濺 緩速藥水
喷溅型力量药水	飛濺 力量藥水
喷溅型迅捷药水	飛濺 迅捷藥水
喷溅型浓稠的药水	飛濺 黏稠藥水
喷溅型神龟药水	飛濺 龜仙藥水
喷溅型水瓶	飛濺 水瓶
喷溅型水肺药水	飛濺 水下呼吸藥水
喷溅型虚弱药水	飛濺 虛弱藥水
喷溅型盘丝药水	飛濺 結網藥水
喷溅型蓄风药水	飛濺 蘊風藥水
望远镜	望遠鏡
鱿鱼刷怪蛋	魷魚 生怪蛋
木棍	木棒
石斧	石斧
石锄	石鋤
石镐	石鎬
石锹	石鏟
石剑	石劍
流浪者刷怪蛋	流髑 生怪蛋
炽足兽刷怪蛋	熾足獸 生怪蛋
线	線
糖	糖
谜之炖菜	可疑的燉湯
甜浆果	甜莓
蝌蚪桶	蝌蚪桶
蝌蚪刷怪蛋	蝌蚪 生怪蛋
潮汐盔甲纹饰	潮汐盔甲紋樣
药箭	藥水箭
不可合成的药箭	不可合成的藥水箭
抗火之箭	抗火之箭
伤害之箭	傷害之箭
治疗之箭	治療之箭
虫蚀之箭	蛀蝕之箭
隐身之箭	隱形之箭
跳跃之箭	跳躍之箭
飘浮之箭	懸浮之箭
幸运之箭	幸運之箭
夜视之箭	夜視之箭
渗浆之箭	滲漿之箭
剧毒之箭	劇毒之箭
再生之箭	回復之箭
缓降之箭	緩降之箭
迟缓之箭	緩速之箭
力量之箭	力量之箭
迅捷之箭	迅捷之箭
神龟之箭	龜仙之箭
喷溅之箭	飛濺之箭
水肺之箭	水下呼吸之箭
虚弱之箭	虛弱之箭
盘丝之箭	結網之箭
蓄风之箭	蘊風之箭
火把花种子	火把花種子
不死图腾	不死圖騰
行商羊驼刷怪蛋	商駝 生怪蛋
试炼钥匙	試煉鑰匙
热带鱼桶	熱帶魚桶
热带鱼刷怪蛋	熱帶魚 生怪蛋
海龟壳	海龜殼
海龟鳞甲	海龜鱗甲
海龟刷怪蛋	海龜 生怪蛋
恼鬼盔甲纹饰	惱鬼盔甲紋樣
恼鬼刷怪蛋	惱鬼 生怪蛋
村民刷怪蛋	村民 生怪蛋
卫道士刷怪蛋	衛道士 生怪蛋
流浪商人刷怪蛋	流浪商人 生怪蛋
监守盔甲纹饰	伏守盔甲紋樣
监守者刷怪蛋	伏守者 生怪蛋
诡异菌钓竿	扭曲蕈菇釣竿
水桶	水桶
向导盔甲纹饰	嚮導盔甲紋樣
小麦	小麥
小麦种子	小麥種子
白色收纳袋	白色束口袋
白色染料	白色染料
白色挽具	白色帽鞍
荒野盔甲纹饰	荒野盔甲紋樣
女巫刷怪蛋	女巫 生怪蛋
凋灵骷髅刷怪蛋	凋零骷髏 生怪蛋
凋灵刷怪蛋	凋零怪 生怪蛋
狼铠	狼鎧
狼刷怪蛋	狼 生怪蛋
木斧	木斧
木锄	木鋤
木镐	木鎬
木锹	木鏟
木剑	木劍
书与笔	書和羽毛筆
成书	完成的書
黄色收纳袋	黃色束口袋
黄色染料	黃色染料
黄色挽具	黃色帽鞍
僵尸疣猪兽刷怪蛋	豬屍獸 生怪蛋
僵尸马刷怪蛋	殭屍馬 生怪蛋
僵尸刷怪蛋	殭屍 生怪蛋
僵尸村民刷怪蛋	殭屍村民 生怪蛋
僵尸猪灵刷怪蛋	殭屍化豬布林 生怪蛋
装备时：	裝備時：
穿戴时：	穿戴時：
穿在身上时：	裝備在身上時：
穿在脚上时：	裝備在腳上時：
手持时：	手持時：
戴在头上时：	裝備於頭部時：
穿在腿上时：	裝備在腿上時：
在主手时：	在慣用手時：
在副手时：	在非慣用手時：
装备鞍时：	裝備鞍時：
NBT：%s个标签	NBT：%s 個標籤
警告：	警告：
使用该物品可能会导致命令执行	使用此物品可能會導致指令執行
除非知道确切内容，否则请勿使用！	除非您完全了解其內容，否則請勿使用！
已在和平难度下禁用	已於和平難易度下停用
无法破坏	無法破壞
建筑方块	建築方塊
染色方块	染色方塊
战斗用品	戰鬥
消耗品	消耗品
合成用品	合成用品
食物与饮品	食物及飲品
功能方块	功能方塊
已保存的快捷栏	已儲存的快捷欄
原材料	原材料
生存模式物品栏	生存模式物品欄
自然方块	自然方塊
管理员用品	管理員實用物品
红石方块	紅石方塊
搜索物品	搜尋物品
刷怪蛋	生怪蛋
工具与实用物品	工具及實用物品
未知的物品修饰器：%s	未知的物品屬性：%s
转变为：	轉變為：
固定	固定
可旋转	可旋轉
拼接类型：	拼接類型：
保留拼图	儲存拼圖
层数：%s	層數：%s
名称：	名稱：
放置优先级：	放置優先順序：
当此拼图方块连接到部件时，此处即为在更大的结构中各部件处理连接的顺序。\n\n部件按照优先级由高到低处理，若优先级相同，则按照插入顺序处理。	當此拼圖方塊連接到某個部件時，此處即為在更大的結構中各部件的處理連接的順序。\n\n部件依照優先順序由高到低處理，若優先順序相同，則依插入順序處理。
目标池：	目標池：
选择优先级：	選擇優先順序：
当父级片段处理连接时，此处即为各拼图方块尝试连接目标部件的顺序。\n\n拼图方块将会按照优先级由高到低处理，同级则随机处理。	當父級部件處理連接時，此處即為拼圖方塊嘗試連接到目標部件的順序。\n\n拼圖方塊會依照優先順序由高到低處理，若優先順序相同，則依隨機順序處理。
目标名称：	目標名稱：
攻击/摧毁	攻擊／破壞
向后移动	後退
游戏内容	遊戲控制
移动	角色移動
多人游戏	多人遊戲
游戏界面	遊戲介面
打开聊天栏	開啟聊天欄
输入命令	開啟指令視窗
丢弃所选物品	丟棄已選擇的物品
向前移动	前進
切换全屏显示	切換全螢幕
快捷栏1	快捷欄 1
快捷栏2	快捷欄 2
快捷栏3	快捷欄 3
快捷栏4	快捷欄 4
快捷栏5	快捷欄 5
快捷栏6	快捷欄 6
快捷栏7	快捷欄 7
快捷栏8	快捷欄 8
快捷栏9	快捷欄 9
开启/关闭物品栏	開啟／關閉物品欄
跳跃	跳躍
'	'
\	\
Backspace	Backspace
Caps Lock	Caps Lock
,	,
Delete	Delete
下方向键	↓ 鍵
End	End
Enter	Enter
=	=
Esc	Esc
F1	F1
F10	F10
F11	F11
F12	F12
F13	F13
F14	F14
F15	F15
F16	F16
F17	F17
F18	F18
F19	F19
F2	F2
F20	F20
F21	F21
F22	F22
F23	F23
F24	F24
F25	F25
F3	F3
F4	F4
F5	F5
F6	F6
F7	F7
F8	F8
F9	F9
`	`
Home	Home
Insert	Insert
小键盘 0	數字鍵 0
小键盘 1	數字鍵 1
小键盘 2	數字鍵 2
小键盘 3	數字鍵 3
小键盘 4	數字鍵 4
小键盘 5	數字鍵 5
小键盘 6	數字鍵 6
小键盘 7	數字鍵 7
小键盘 8	數字鍵 8
小键盘 9	數字鍵 9
小键盘 +	數字鍵 +
小键盘 .	數字鍵 .
小键盘 /	數字鍵 /
小键盘 Enter	數字鍵 Enter
小键盘 =	數字鍵 =
小键盘 *	數字鍵 *
小键盘 -	數字鍵 -
左方向键	← 鍵
左Alt	左 Alt
[	[
左Ctrl	左 Ctrl
左Shift	左 Shift
左Win	左 Windows
菜单	選單鍵
-	-
Num Lock	Num Lock
Page Down	Page Down
Page Up	Page Up
Pause	Pause
.	.
Print Screen	Print Screen
右方向键	→ 鍵
右Alt	右 Alt
]	]
右Ctrl	右 Ctrl
右Shift	右 Shift
右Win	右 Windows
Scroll Lock	Scroll Lock
;	;
/	/
空格	空白鍵
Tab	Tab
未指定	未指定
上方向键	↑ 鍵
World 1	World 1
World 2	World 2
向左移动	往左
加载快捷栏	載入快捷欄
鼠标按键%1$s	滑鼠鍵 %1$s
左键	左鍵
中键	中鍵
右键	右鍵
选取方块	選取方塊
显示玩家列表	列出玩家
快捷操作	快速動作
向右移动	往右
保存快捷栏	儲存快捷欄
截图	擷取螢幕畫面
切换电影视角	切換視角平滑移動
潜行	潛行
社交屏幕	社群交流畫面
高亮玩家（旁观者）	標示玩家（旁觀者）
疾跑	跑步
与副手交换物品	互換雙手物品
切换视角	切換視角
使用物品/放置方块	使用物品／放置方塊
公告	公告
社区	社群
社区方针	社群規範
反馈	意見回饋
论坛	論壇
新闻	新聞
报告服务器漏洞	回報伺服器錯誤
状态	狀態
支持	支援
网站	網站
对其他玩家的设置	對其他玩家的設定
端口号	連接埠號碼
端口无效。\n请将编辑框留空，或输入一个介于1024和65535之间的数字。	無效的連接埠。\n請將編輯欄留空，或是輸入一個 1024 到 65535 之間的數值。
端口无效。\n请将编辑框留空，或输入一个介于%s和%s之间的数字。	無效的連接埠。\n請將編輯欄留空，或是輸入一個 %s 到 %s 之間的數值。
端口不可用。\n请将编辑框留空，或输入一个介于1024和65535之间的新数字。	無法使用這個連接埠。\n請將編輯欄留空，或是輸入一個 1024 到 65535 之間的新數值。
端口不可用。\n请将编辑框留空，或输入一个介于%s和%s之间的新数字。	無法使用這個連接埠。\n請將編輯欄留空，或是輸入一個 %s 到 %s 之間的新數值。
正在你的本地网络中寻找游戏	正在您的區域網路內尋找可供加入的遊戲
创建局域网世界	開始區網世界
局域网世界	區網世界
zho-Hans_CN	zho-Hant_TW
简体中文	繁體中文
中国大陆	台灣
取书	取下書本
%s%%	%s%%
阅读更多关于Mojang和其他隐私政策的信息	閱讀更多關於 Mojang 以及隱私權法的資訊
阅读关于《通用数据保护条例》的内容	關於《一般資料保護規則》(GDPR)
Mojang实施许多方法来帮助保护儿童及其隐私权，包括履行《儿童在线隐私权保护法案》（COPPA）与《通用数据保护条例》（GDPR）。\n\n在取得Realms账户访问权之前，你可能需要获得父母的同意。	Mojang 為了保護兒童及其隱私權施行了許多政策，包含《兒童線上隱私保護法》(COPPA) 與《一般資料保護規則》(GDPR)。\n\n您在存取 Realms 帳號之前可能需要取得家長的同意。
Mojang实施许多方法来促进儿童及其隐私权的保护，包括履行《儿童在线隐私权保护法案》（COPPA）与《通用数据保护条例》（GDPR）。\n\n在访问你的Realms账户之前，你可能需要征得父母的同意。\n\n如果你拥有的是旧版的Minecraft账户（登录时使用用户名），你需要将其合并到Mojang账户以访问Realms。	Mojang 為了保護兒童及其隱私權施行了許多政策，包含《兒童線上隱私保護法》(COPPA) 與《一般資料保護規則》(GDPR)。\n\n您在存取 Realms 帳號之前可能需要取得家長的同意。\n\n如果您擁有較舊的 Minecraft 帳號（以使用者名稱登入），您必須將帳號轉移為 Mojang 帳號以使用 Realms。
更新账户	更新帳號
过去%s天无动态	在過去的 %s 天沒有活動
玩家动态	玩家活動
下载最新版本	下載最新備份
重置世界	重設世界
还原	還原
上传世界	上傳世界
更改	改變
备份（%s）	備份 (%s)
描述	詳細資訊
已启用的资源包	已啟用的資源或資料包
游戏难度	遊戲難易度
游戏模式	遊戲模式
游戏服务器版本	遊戲伺服器版本
名称	名稱
种子	種子碼
模板名称	模板名稱
未定义的更改	未定義的變更
已上传	已上傳
世界类型	世界類型
生成世界	產生世界
自上次备份以来发生的更改	自上次備份以來發生的變更
备份自%s	自 %s 備份
这个Realm目前没有任何备份。	這個 Realm 目前沒有任何備份。
正在还原你的Realm	正在還原您的 Realm
下载	下載
已下载	已下載
请重置或选择另一个世界。	請重設或選擇另一個世界。
你可以选择将世界下载至单人模式中。	你也可以下載此地圖到單人遊戲
此小游戏已不受支持	這個小遊戲不再被支援
请等待Realm所有者重置世界	請等待 Realm 的擁有者重設世界
世界已过期	世界已過期
开始游戏	開始遊戲
当前的世界已不受支持	你當前的世界不再被支援
你的客户端与Realms不兼容。	您的用戶端與 Realms 不相容。
请使用最新版本的Minecraft。	請使用最新版本的 Minecraft。
Realms不与快照版本兼容。	Realms 與快照版本不相容。
客户端不兼容！	用戶端不相容！
你的客户端版本（%s）与Realms不兼容。\n\n请使用最新版本的Minecraft。	您的用戶端版本 (%s) 與 Realms 不相容。\n\n請使用最新版本的 Minecraft。
你的客户端版本（%s）与Realms不兼容。\n\nRealms在此快照版本不可用。	您的用戶端版本 (%s) 與 Realms 不相容。\n\nRealms 無法在這個快照版本使用。
降级	降低版本
这个世界上次是在%s版本中打开的，你正在使用%s版本。降低世界的游戏版本可能会导致存档损坏，我们无法保证它可以正确加载和运行。\n\n此世界的备份将会保存在“世界备份”下。如有需要，请恢复原来的世界。	這個世界最後一次遊玩的版本為 %s，而您使用的版本為 %s。降低世界版本可能導致資料損毀，我們無法保證世界能讀取或正常運作。\n\n您的世界備份會儲存於「世界備份」中。如有需要可復原世界。
版本不兼容	版本不相容
尝试加入的世界与所在版本不兼容。	您嘗試加入的世界與目前版本不相容。
这个世界上次是在%s版本中打开的，你正在使用%s版本。\n\n这些系列互不兼容。此版本需要创建新的世界。	這個世界最後一次遊玩的版本為 %s，而您使用的版本為 %s。\n\n這些版本互不相容。需要建立新的世界才能遊玩這個版本。
无法验证上次打开这个世界的版本。如果升级或降级这个世界，备份将会被自动创建并保存在“世界备份”下。	無法驗證這個世界上一次遊玩的版本。如果升級或降級世界的版本，則會自動建立備份，並儲存於「世界備份」中。
无法验证兼容性	無法驗證相容性
升级	升級
这个世界上次是在%s版本中打开的，你正在使用%s版本。\n\n此世界的备份将会保存在“世界备份”下。如有需要，请恢复原来的世界。	這個世界最後一次遊玩的版本為 %s，而您使用的版本為 %s。\n\n您的世界備份會儲存於「世界備份」中。\n\n如有需要可復原世界。
这个世界上次是在%s版本中打开的，你正在使用%s版本。\n\n此世界的备份将会保存在“世界备份”下。\n\n如有需要，Realm的所有者可以恢复原来的世界。	這個世界最後一次遊玩的版本為 %s，而您使用的版本為 %s。\n\n您的世界備份會儲存於「世界備份」中。\n\n如有需要，Realm 的擁有者可復原世界。
你真的想升级此世界吗？	您確定要升級這個世界嗎？
当前	目前
玩家推送暂不可用	玩家動態暫時無法使用
世界备份	世界備份
暂时关闭Realm	暫時關閉 Realm
删除	刪除
设置	設定
邀请玩家	邀請玩家
更多选项	更多選項
新的世界	新的世界
重新打开Realm	重新開啟 Realm
世界选项	世界選項
选择地区…	選擇地區...
保存	儲存
订阅	訂閱
切换小游戏	切換小遊戲
你可以暂时关闭Realm，从而防止有人在你调整设置时进入游戏。准备就绪后Realm可以重新打开。\n\n此操作不会取消你的Realms订阅。	您可以暫時關閉 Realm，以防有人在調整時進入遊玩。準備就緒後就可以重新開啟。\n\n此操作不會取消您的 Realms 訂閱。
你确定要继续吗？	您確定要繼續嗎？
要在不中断的情况下更改吗？	需要在不中斷遊玩的情況下，做出變更嗎？
暂时关闭Realm中…	正在暫時關閉 Realm...
删除Realm	刪除 Realm
你的Realm将被永久删除	你的 Realm 將被永久刪除
Realm描述	Realm 的描述
世界名称	世界名稱
由于你当前的世界是冒险世界，有些选项将会被禁用	由於您目前的世界是冒險世界，因此某些設定將被停用
由于你当前的世界是体验世界，有些选项将会被禁用	由於您目前的世界是體驗世界，因此某些設定將被停用
由于你当前的世界是示例世界，有些选项将会被禁用	由於您當前的世界為靈感，因此某些設定將被停用
强制游戏模式	鎖定遊戲模式
你有%s个新邀请	您有 %s 個新邀請
已邀请	已邀請
已邀请（%s）	已邀請 (%s)
普通玩家	普通玩家
管理员	管理員
移除	移除
如果你离开这个Realm，你只有被再次邀请才能看见它	如果你離開了這個 Realm，除非再次受到邀請，否則您將不會再看到它
加载Realm中	正在載入 Realm
位置	位置
当前：%s	目前：%s
Realm名称	Realm 名稱
开启Realm中…	正在開啟 Realm...
不存在该指定名称的玩家	提供之玩家名稱不存在
此Realm中已邀请过使用该名称的玩家	使用此名稱的玩家已經被邀請到此 Realm
邀请玩家中…	正在邀請玩家...
玩家对战	玩家對戰
地区偏好	地區偏好
地区偏好选择	地區偏好選擇
你的Realm将被重新生成，而当前的Realm将会消失	您的世界將重新生成，您將失去當前的世界
这个Realm需要一个自定义的资源包\n\n你想要自动下载并安装它吗？	這個 Realm 需使用自訂的資源包\n\n您想要自動下載並安裝它嗎？
这个Realm需要一个自定义的资源包	這個 Realm 需使用自訂的資源包
你想要自动下载并安装它吗？	您想要自動下載並安裝它嗎？
世界将会被下载并添加至你的单人游戏世界中	世界將在下載後加入您的單人遊戲世界中。
你的Realm世界将被还原至“%s”（%s）	你的 Realm 世界將被還原至日期 '%s' (%s)
你无法编辑已过期Realm的设置	您無法編輯已過期 Realm 的設定
世界%s	世界 %s
你的Realm将会被切换至另一个世界	您的 Realm 將被切換至另一個世界
切换到世界	切換到世界
加入	加入
切换至小游戏	切換至小遊戲
生成动物	生成動物
生成怪物	生成怪物
生成NPC	生成 NPC
重生点保护	重生點保護
关闭此选项后，所有现有的该类型实体将会被移除	關閉此選項將會移除該類型的所有現存實體
关闭此选项后，所有现有的该类型实体将会被移除，例如村民	關閉此選項將會移除該類型的所有現存實體，例如村民
警告！	警告！
天	天
已过期	已過期
延长订阅时间	延長訂閱時間
不足一天	少於一天
月	個月
自动续期剩余时间：	將自動更新於
对你的Realms订阅所做的更改（如续期和取消自动续订）将在下个结算日生效。	對您的 Realms 訂閱所做的變更（例如續期或關閉自動續費等）將在您的下一個帳單日期生效。
%1$s天	%1$s 天
%1$s个月	%1$s 個月
%1$s个月%2$s天	%1$s 個月 %2$s 天
开始日期	開始日期
剩余时间	剩餘時間
订阅信息	訂閱內容資訊
创建世界	建立世界
这个世界是空的，请选择创建世界的方式	這個世界是空的，請選擇您要進行的動作
配置Realm：	設定 Realm：
你确定要取消邀请“%s”吗？	您確定要取消邀請「%s」嗎？
你确定要取消邀请吗	您是否確定要取消邀請
正在连接至Realm…	正在連線至 Realm...
无法连接至Realm	無法連線至 Realm
服务器地区：%s	伺服器地區：%s
创建	建立
你必须输入一个名字！	您必須輸入一個名稱！
创建世界失败！	無法建立世界！
正在创建世界…	正在建立世界...
跳过	略過
可选，选择你想放进新Realm的世界	隨個人喜好，選擇要放進您新 Realm 的世界
正在创建Realm…	正在建立 Realm...
下载已取消	下載已取消
你将下载的世界大小大于%s	您即將下載的世界檔案大小大於 %s
你无法再次将这个世界上传至Realm	您將無法再度上傳這個世界至 Realm。
你将下载的世界大小大于%s\n\n你无法再次将这个世界上传至Realm	您即將下載的世界檔案大小大於 %s\n\n您將無法再度上傳這個世界至 Realm
下载完成	下載完成
正在下载	下載中
提取中	正在提取中
下载失败	下載失敗
%s %%	%s %%
正在准备下载	正在準備下載
资源包下载失败！	資源包下載失敗！
（%s/s）	(%s/s)
%s每秒	每秒%s
下载最新的世界	下載最新的世界
请尝试重启Minecraft	請嘗試重新開啟 Minecraft
无效会话	無效的 session
客户端已过期！	用戶端版本太舊
尚未同意服务条款	尚未接受使用條款
超过下载限制	超過下載限制
超过上传限制	超過上傳限制
世界已锁定	世界已鎖定
玩家所在的Realm数量过多	玩家所在的 Realms 過多
无效的Realm名称	無效的 Realm 名稱
无效的Realm描述	無效的 Realm 描述
出错了，请稍后再试。	發生錯誤，請稍後再試。
出现错误：	發生錯誤：
初始化Realm失败	無法初始化 Realm
未提供错误详情	未提供錯誤詳細資訊
出现错误（%s）：	發生錯誤（%s）：
编辑世界选项时出现意外错误	編輯世界選項時發生了非預期的錯誤
无法连接至Realm：%s	無法連線到 Realms：%s
Realms（%s）：	Realms（%s）：
无法检查兼容版本，响应为：%s	無法檢查相容版本，回應為：%s
重试操作	請重新操作
Realms目前处于繁忙状态。\n请在几分钟后再次尝试连接至你的Realm。	Realms 目前忙碌中。\n請稍候數分鐘再重新嘗試連線。
按钮	按鈕
信息！	資訊！
已邀请玩家%s	已邀請玩家 %s
接受	接受
拒绝	拒絕
没有未决邀请！	沒有待處理的邀請！
新邀请！	新邀請！
未决邀请	待處理的邀請
选择另一个小游戏	選擇另一個小遊戲
这会暂时将你的世界替换成一个小游戏！	此操作將把您的世界暫時替換為小遊戲！
之后你可以毫无损失地返回到原来的世界。	之後您可以毫無損失地返回到原來的世界。
请选择	請選擇
结束小游戏中…	正在結束小遊戲...
小游戏将结束而你的Realm将被恢复。	小遊戲將結束，你的 Realm 將被還原。
所选的小游戏：	已選擇的小遊戲：
切换世界中…	正在切換世界...
切换	切換
开始小游戏中…	正在開始小遊戲...
结束小游戏	結束小遊戲
选择另一个小游戏？	選擇另一個小遊戲？
将Realm切换成小游戏	將 Realm 切換至小遊戲
Realms新闻	Realms 新聞
关闭	關閉
立即转移	立即轉移
Java版Realms订阅即将转移到Microsoft Store。别让你的订阅过期了！\n现在转移即可免费获得30天的Realms服务。\n请在minecraft.net的“档案”页面转移你的订阅。	Java Realms 訂閱正在轉移至 Microsoft Store。別讓您的訂閱過期！\n現在轉移即可免費獲得 30 天的 Realms。\n請前往 minecraft.net 的「個人檔案」頁面以轉移您的訂閱。
打开链接	開啟連結
请访问下方的链接	請前往下方連結
在线玩家	線上玩家
Realm已关闭	Realm 已關閉
问题	問題
体验	體驗
示例	靈感
重置世界中…	正在重設世界...
世界种子（可选）	種子碼（可選）
世界模板	Realm 範本
这将替换掉你目前的Realm世界	這將取代您目前的 Realm 世界
购买Realm服务器！	購買 Realm！
已失效的Realm	已關閉的 Realm
关闭Realm	關閉 Realm
配置Realm	設定 Realm
创建Realm	建立 Realm
选择想放进你新Realm的世界	選擇要放進你新 Realm 的世界
已过期的Realm	已過期的 Realm
你的订阅已过期	您的 Realm 訂閱已經過期
续期	續期
你的试用期已结束	您的試用期已結束
将在一天内过期	一天內將到期
将在%s天后过期	還有 %s 天到期
即将过期	即將到期
离开Realm	離開 Realm
加载Realm列表中	正在載入 Realm 清單
此地图不受%s支持	此地圖在 %s 不被支援
小游戏：	小遊戲：
小游戏：%s	小遊戲：%s
无法在%s中进行这个小游戏	不能在 %s 玩這個小遊戲
你似乎还没有Realm。添加Realm与朋友们一同畅玩。	你似乎還沒有 Realm。新增 Realm 來與朋友一起遊玩。
注意：	注意：
已开启的Realm	開啟 Realm
开启Realm	開啟 Realm
Realms最多可以同时支持十位好友安全且简单地在线享受Minecraft世界。它也支持多种小游戏与海量自定义世界！只有Realm的所有者需要付款。	Realms可以同時讓最多十位好友安全又簡單地享受線上的 Minecraft 世界。 它支援許多小遊戲與大量的自訂世界！只有 Realm的擁有者需要支付費用。
添加Realm	新增 Realm
开始试用！	取得試用版！
点击以创建新的Realm！	按此建立您的 Realm！
你即将创建免费的快照版Realm，它会与你的付费Realm订阅绑定。新的快照版Realm在付费订阅生效期间可以随时访问。原本的付费Realm不会受到影响。	你即將建立免費的快照版 Realm，它會與您付費的 Realm 訂閱進行綁定。這份新的快照版 Realm 可以在付費訂閱生效期間隨時存取。原本的付費 Realm 將不會受到影響。
是否创建快照版Realm？	是否建立快照版 Realm？
正在创建快照版Realm…	正在建立快照版 Realm…
与%s绑定	與 %s 綁定
你需要使用版本%s加入此Realm	您需要使用版本 %s 來加入這個 Realm
在你使用此快照进行游戏之前，%s需要升级其Realm	在您使用這個快照進行遊戲前，%s 需升級其 Realm
此快照版Realm与%s绑定	這個快照版 Realm 與 %s 綁定
使用最新正式版Minecraft以进入此Realm	使用最新版的 Minecraft 遊玩這個 Realm
开启免费的快照版Realm	開啟免費的快照版 Realm
这是与你的Realm订阅“%s”绑定的快照版Realm。它会在与其绑定的Realm可用时保持可用。	這是與您 Realm 訂閱「%s」綁定的快照版 Realm。與其綁定的 Realm 可以使用時，它也會維持能夠使用。
使用快照版Realm抢先了解即将推出的Minecraft版本，其中可能包括新功能和其他更改。\n\n你可以在游戏的正式版中找到普通的Realm。	使用快照版 Realm 搶先體驗即將推出的 Minecraft 版本，其中可能包含了新功能及其他改動。\n\n您可以在遊戲的正式版本中找到一般的 Realm。
Realms从23w41a开始可在快照版本中使用。每份Realms订阅中包含一份和你普通Java版Realm相互独立的免费快照版Realm！	從快照 23w41a 開始，Realms 可於快照中使用。每份 Realms 訂閱中，包含了一份獨立於您的普通 Java 版 Realm 的快照版 Realm！
Realms现可在快照版本中使用	Realms 現在可於快照中使用
了解更多	了解更多
发布者	發布者
选择	選擇
预告片	預告片
发布者的网站	發布者網站
模板	樣板
我们无法接收这个分类的内容。\n请检查你的网络连接，或稍后再试。	我們無法接收這個類別的內容清單。\n請檢查您的網路連線，或是稍後再嘗試。
作者：%s	作者：%s
版本：%s	版本 %s
抱歉，看来这个分类目前是空的。\n请之后再回来检查是否有新内容，如果你是一名创作者的话，\n%s。	噢，這個類別目前似乎是空的。\n請之後再回來尋找新內容，而如果您是一位創作者，\n%s。
尝试自己提交一些自己的内容	您可以考慮上傳一些自己的東西
Realm小游戏	Realm 小遊戲
地图预告	地圖預告片
同意	同意
不同意	不同意
我已阅读并接受Minecraft Realms的	我同意 Minecraft Realms 所列明的條款
服务条款	使用條款
Realms服务条款	Minecraft Realms 使用條款
%1$s天前	%1$s 天前
%1$s小时前	%1$s 小時前
%1$s分钟前	%1$s 分鐘前
刚刚	現在
%1$s秒前	%1$s 秒前
你想获得属于自己的Realm吗？	想獲得屬於您自己的 Realm 嗎？
点击此处来获得更多消息！	按此獲得更多資訊
上传	上傳
上传已取消	上傳已取消
无法关闭你的Realm，请稍后再试	無法關閉您的 Realm，請稍後再試
上传已完成	上傳完成
%1$s, %2$s	%1$s, %2$s
%1$s（%2$s）	%1$s (%2$s)
上传失败！（%s）	上傳失敗！(%s)
选中的世界过大。最大允许大小为%s。	選取的世界過大。大小不得超過 %s。
世界过大	世界過大
不能上传极限模式世界！	不可上傳極限模式的世界！
正在准备你的世界数据	正在準備您的世界資料
找不到单人游戏世界！	找不到單人遊戲世界！
请选择一个单人游戏世界来上传	請選擇一個單人遊戲世界來上傳
“%s”太大了！	「%s」太大了！
你想上传%s的地图，超过了%s的限制。	大小為 %s。大小上限為 %s。
正在上传“%s”	正在上傳「%s」
正在验证你的世界	正在驗證您的世界
小游戏	小遊戲
自定义选项…	自訂選項...
自定义选项	自訂選項
注：自定义选项由第三方服务器或内容提供。\n请小心操作！	注意：自訂選項是由第三方伺服器與／或內容提供。\n請小心使用！
这是一个自定义屏幕。了解更多信息。	這是一個自訂畫面。了解更多資訊。
此屏幕的内容由第三方服务器或地图控制，不由Mojang Studios或Microsoft拥有、运营和监督。\n\n请小心操作！点击链接时请务必谨慎，确保不要泄露你的个人信息，包括账号密码等。\n\n如果此屏幕阻止你继续，可以点击下方按钮与当前服务器断开连接。	這個畫面的內容是由第三方伺服器和地圖控制，不由 Mojang Studios 或 Microsoft 擁有、營運或監督。\n\n請小心操作！點擊連結時務必謹慎，切勿洩露你的個人資訊，包括帳號密碼等。\n\n如果這個畫面阻止你繼續，可以點擊下方按鈕從目前伺服器中斷連線。
已拒绝自定义屏幕	已拒絕自訂畫面
关于自定义屏幕的说明	關於自訂畫面的說明
这是一个自定义屏幕。点击此处了解更多信息。	這是一個自訂畫面。按此了解更多資訊。
断开连接	中斷連線
反馈…	意見回饋...
游戏菜单	遊戲目錄
（已修改）	 (Modded)
Minecraft Realms	Minecraft Realms
选项…	選項...
游戏暂停	遊戲暫停
开始试玩世界	遊玩試玩世界
准备生成区域中：%s%%	正在準備重生點區域：%s%%
快捷操作…	快速動作...
退出游戏	離開遊戲
报告漏洞	回報錯誤
重置试玩世界	重設試玩世界
回到游戏	繼續遊戲
保存并退回到标题屏幕	儲存並回到標題畫面
保存区块中	正在儲存區塊
保存世界中	正在儲存世界
提供反馈	提供意見回饋
服务器链接…	伺服器連結...
服务器链接	伺服器連結
对局域网开放	在區網上公開
单人游戏	單人遊戲
处理中…	正在處理...
村民每天最多补货两次。	村民每天最多補貨兩次。
新手	新手
学徒	學徒
老手	老手
专家	專家
大师	大師
%s - %s	%s - %s
交易	交易
↑ ↓	↑ ↓
← →	← →
|	|
按下%1$s来脱离	按 %1$s 取消乘坐
正在应用资源包	正在套用資源包
你尝试执行的命令无法识别或无效。\n确定要执行吗？\n命令：%s	你嘗試執行的指令無法辨識或無效。\n確定要執行嗎？\n指令：%s
你尝试执行的命令需要较高的权限。\n这可能会对游戏产生负面影响。\n确定要执行吗？\n命令：%s	你嘗試執行的指令需要較高的權限。\n這可能會對你的遊戲產生負面影響。\n確定要執行嗎？\n指令：%s
确认执行命令	確認執行指令
身份验证服务器目前处于宕机状态。请稍后再试，抱歉！	驗證伺服器暫停服務，請稍後再試，非常抱歉！
检测到来自服务器的聊天消息部分缺失或已被重新排序	偵測到來自伺服器已遺失或已重新排序的聊天訊息
你已被此服务器封禁	您已經被這個伺服器封鎖
\n你的封禁将于%s解除	\n您的封鎖將於 %s 解除
你已被此服务器封禁。\n原因：%s	您已被這個伺服器封鎖。\n原因：%s
你的IP已被此服务器封禁。\n原因：%s	您的 IP 位址已被這個伺服器封鎖。\n原因：%s
聊天消息验证失败	聊天訊息驗證失敗
配置时出现意外错误	設定時發生非預期的錯誤
你已在异地登录	您已從其他位置登入
个人信息公钥过期。请确保系统时间同步，然后尝试重启游戏。	個人資訊公鑰已過期。請檢查系統時間已同步處理，並嘗試重新啟動遊戲。
此服务器未启用飞行	此伺服器並沒有啟用飛行
你的未操作时间过长！	您的閒置時間過長！
非法聊天字符	聊天欄中出現不允許的字元
客户端不兼容！请使用%s	用戶端不相容！請使用 %s
试图攻击无效实体	試圖攻擊無效的實體
服务器发送了一个无效的数据包	伺服器傳送無效的封包
无效的玩家数据	無效的玩家資料
收到了包含非法玩家移动的数据包	接收到無效的玩家移動封包
无效的个人信息公钥签名。\n请尝试重启游戏。	無效的個人資訊公鑰。\n請嘗試重啟遊戲。
收到了包含非法载具移动的数据包	接收到無效的載具移動封包
你的IP地址已被此服务器封禁	您的 IP 位址已被這個伺服器封鎖
被管理员踢出游戏	已被管理員踢出
从服务器接收到不完整标签集。\n请联系服务器管理员。	從伺服器接收到不完整的標籤集。\n請聯絡伺服器管理員。
此名称已被占用	該名稱已被使用
你不在此服务器的白名单中！	你不在這個伺服器的白名單中！
接收到了乱序的聊天数据包。你的系统时间是否被更改过？	收到的聊天封包順序不正確。您的系統時間是否已變更？
服务器已满！	伺服器已滿！
服务器已关闭	伺服器已關閉
登录超时	登入逾時
没有确认的聊天消息过多	太多未經認可的聊天訊息
服务器不接受转移	伺服器不接受轉移
从客户端收到未知的自定义数据	從用戶端接收到預期外的自訂資料
接收到了缺少签名或含有无效签名的聊天数据包。	收到缺少或含有無效簽章的聊天封包。
验证用户名失败！	無法驗證使用者名稱！
正在获取统计信息…	正在下載統計資訊...
加载地形中…	正在載入地形...
发现新的服务器：%s	找到新的伺服器：%s
无法发送聊天消息，请检查服务器日志：%s	無法傳送聊天訊息，請檢查伺服器紀錄：%s
%s加入了游戏	%s 加入了遊戲
%s（之前被称为%s）加入了游戏	%s （之前是 %s）加入了遊戲
%s退出了游戏	%s 離開了遊戲
%s生命值	%s 生命值
在线玩家：%s	在線玩家：%s
服务器需要自定义资源包	伺服器要求使用其自訂的資源包
这个服务器需要使用自定义的资源包。	此伺服器要求使用其自訂的資源包。
拒绝使用该自定义资源包将会断开你与该服务器的连接。	拒絕此自訂資源包將使你和伺服器的連線中斷。
社交屏幕仅在多人游戏世界中可用	社群交流僅適用於多人遊戲世界
…及其他%s名玩家…	... 以及另外 %s 人 ...
已取消	已取消
无法连接到服务器	無法連線到伺服器
无法解析主机名	無法解析主機名稱
已完成	完成
版本不兼容！	遊戲版本不相容！
服务器信息：%s	伺服器訊息：%s
（无连接）	（未連線）
旧版	舊版
在线	線上
%s毫秒	%s 毫秒
延迟为%s毫秒	延遲為 %s 毫秒
检测中…	Pinging...
%s名玩家在线，共%s名玩家	有 %s 位玩家在線上，共 %s 位玩家
正在退出	正在離開
状态请求已处理	已處理傳送的狀態請求
收到了未请求的状态	接收到未請求的資訊
服务器版本：%s	伺服器版本：%s
起床	起床
无法应用服务器资源包	無法套用伺服器資源包
所有依赖自定义资源包的功能都有可能不按预期工作	任何需要自訂資源包的功能可能無法依預期執行
这个服务器推荐使用自定义的资源包。	此伺服器建議使用其自訂的資源包。
你想要自动下载和安装它吗？	您是否希望它自動下載並安裝？
%s\n\n来自服务器的消息：\n%s	%s\n\n訊息來自於以下伺服器：\n%s
该服务器上发送的消息可能会被修改，可能无法反映原始消息	此伺服器中的聊天訊息可能經過修改，無法反映出原始的訊息
无法验证聊天消息	無法驗證聊天訊息
不再显示此屏幕	不再顯示此畫面
警告：在线游戏由第三方提供	警告：第三方遊戲伺服器
警告：在线游戏由第三方服务器提供，不由Mojang Studios或Microsoft拥有、运营和监督。 在线游戏的过程中，你可能会收到不受规制的聊天消息或者其他用户生成内容，而这些内容可能不适合所有人。	警告：第三方伺服器所提供的遊戲不隸屬於 Mojang Studios 或 Microsoft， 不會受到我們的管理或監督。 線上遊玩時，您可能會遭遇到未受管理的聊天訊息、或是其他由使用者製造的內容，而這些內容可能不適合所有人。
Aaron Cherof - A Familiar Room	Aaron Cherof - A Familiar Room
谷冈久美 - An Ordinary Day	谷岡久美 - An Ordinary Day
Lena Raine - Ancestry	Lena Raine - Ancestry
Amos Roddy - Below and Above	Amos Roddy - Below and Above
Amos Roddy - Broken Clocks	Amos Roddy - Broken Clocks
Aaron Cherof - Bromeliad	Aaron Cherof - Bromeliad
C418 - Clark	C418 - Clark
谷冈久美 - Comforting Memories	谷岡久美 - Comforting Memories
C418 - Aria Math	C418 - Aria Math
C418 - Biome Fest	C418 - Biome Fest
C418 - Blind Spots	C418 - Blind Spots
C418 - Dreiton	C418 - Dreiton
C418 - Haunt Muskie	C418 - Haunt Muskie
C418 - Taswell	C418 - Taswell
Aaron Cherof - Crescent Dunes	Aaron Cherof - Crescent Dunes
C418 - Danny	C418 - Danny
Lena Raine - Deeper	Lena Raine - Deeper
C418 - Dry Hands	C418 - Dry Hands
Aaron Cherof - Echo in the Wind	Aaron Cherof - Echo in the Wind
Lena Raine - Eld Unknown	Lena Raine - Eld Unknown
C418 - Alpha	C418 - Alpha
C418 - Boss	C418 - Boss
C418 - The End	C418 - The End
Lena Raine - Endless	Lena Raine - Endless
Aaron Cherof - Featherfall	Aaron Cherof - Featherfall
Amos Roddy - Fireflies	Amos Roddy - Fireflies
谷冈久美 - Floating Dream	谷岡久美 - Floating Dream
C418 - Haggstrom	C418 - Haggstrom
Lena Raine - Infinite Amethyst	Lena Raine - Infinite Amethyst
C418 - Key	C418 - Key
谷冈久美 - komorebi	谷岡久美 - komorebi
Lena Raine - Left to Bloom	Lena Raine - Left to Bloom
Amos Roddy - Lilypad	Amos Roddy - Lilypad
C418 - Living Mice	C418 - Living Mice
C418 - Mice on Venus	C418 - Mice on Venus
C418 - Minecraft	C418 - Minecraft
C418 - Ballad of the Cats	C418 - Ballad of the Cats
C418 - Concrete Halls	C418 - Concrete Halls
Lena Raine - Chrysopoeia	Lena Raine - Chrysopoeia
C418 - Dead Voxel	C418 - Dead Voxel
Lena Raine - Rubedo	Lena Raine - Rubedo
Lena Raine - So Below	Lena Raine - So Below
C418 - Warmth	C418 - Warmth
Lena Raine - One More Day	Lena Raine - One More Day
Amos Roddy - O's Piano	Amos Roddy - O's Piano
C418 - Oxygène	C418 - Oxygène
谷冈久美 - pokopoko	谷岡久美 - pokopoko
Aaron Cherof - Puzzlebox	Aaron Cherof - Puzzlebox
Lena Raine - Stand Tall	Lena Raine - Stand Tall
C418 - Subwoofer Lullaby	C418 - Subwoofer Lullaby
Lena Raine - Aerie	Lena Raine - Aerie
Lena Raine - Firebugs	Lena Raine - Firebugs
Lena Raine - Labyrinthine	Lena Raine - Labyrinthine
C418 - Sweden	C418 - Sweden
Aaron Cherof - Watcher	Aaron Cherof - Watcher
C418 - Axolotl	C418 - Axolotl
C418 - Dragon Fish	C418 - Dragon Fish
C418 - Shuniji	C418 - Shuniji
Lena Raine - Wending	Lena Raine - Wending
C418 - Wet Hands	C418 - Wet Hands
谷冈久美 - yakusoku	谷岡久美 - yakusoku
C418 - Beginning 2	C418 - Beginning 2
C418 - Floating Trees	C418 - Floating Trees
C418 - Moog City 2	C418 - Moog City 2
C418 - Mutation	C418 - Mutation
按钮：%s	按鈕：%s
按下Enter键激活	按下 Enter 以啟用
单击鼠标左键激活	按下左鍵以啟用
复选框：%s	核取方塊：%s
按下Enter键切换	按下 Enter 以切換
单击鼠标左键切换	按下左鍵以切換
按下Tab键移动到下一个屏幕控件	按 Tab 移動到下個元素
按下Enter键切换到%s	按下 Enter 以切換至 %s
单击鼠标左键切换到%s	按下左鍵以切換至 %s
编辑框：%s	編輯欄：%s
物品：%s	物品：%s
%s的配方	%s 的合成配方
单击鼠标左键选中	按下左鍵以選取
单击鼠标右键显示更多配方	按下右鍵顯示更多合成配方
使用上下方向键移动到另一项	按上下方向鍵移動到其他項目
使用左右方向键更改数值	按下左右方向鍵變更數值
按下Enter键开始更改滑块值	按下 Enter 開始變更滑桿數值
拖动滑块更改数值	拉動滑桿以變更數值
已选中%2$s项建议中的第%1$s项：%3$s	已從 %2$s 項建議中選擇了第 %1$s 項：%3$s
已选中%2$s项建议中的第%1$s项：%3$s（%4$s）	已從 %2$s 項建議中選擇了第 %1$s 項：%3$s (%4$s)
按下Tab键切换到下一个建议	按下 Tab 以切換至下一個建議
按下Tab键切换到下一个建议，或按下Escape键忽略建议	按下 Tab 以切換至下一個建議，或按下 Escape 以忽略建議
按下Tab键使用建议	按下 Tab 以使用建議
按下Tab键使用建议，或按下Escape键忽略建议	按下 Tab 以使用建議，或按下 Escape 以忽略建議
按下Ctrl键和Tab键切换标签页	使用 Ctrl 及 Tab 鍵以切換頁籤
辅助功能	協助工具
难度锁定	難易度鎖定
未锁定	未鎖定
语言	語言
%s已绑定至%s	%s 已被綁定為 %s
重置%s按钮	重設 %s 按鈕
%s未绑定	%s 未被綁定
加入中	正在加入
加载中：%s	正在載入：%s
已选中列表的第%s行，共%s行	已選擇清單 %2$s 列中的第 %1$s 列
已选中一列控件中的第%s项，共%s项	已選擇 %2$s 個列元素中的第 %1$s 個
第%s个屏幕控件，共%s个	%2$s 個畫面元素中的第 %1$s 個
已选中第%s个标签页，共%s个	已選擇第 %s 個頁籤，共 %s 個
准备就绪	準備就緒
使用鼠标指针或Tab键选择屏幕控件	使用滑鼠游標或是 Tab 鍵選擇元素
已选择：%s	已選擇：%s
已选择%s，上次进入游戏：%s，%s，%s，版本：%s	已選擇 %s，最後遊玩時間為 %s，%s，%s，版本為 %s
已选择%s，上次进入游戏：%s，%s	已選擇 %s，上次遊玩時間：%s，%s
复述功能已关闭	已關閉朗讀功能
复述功能已开启	已啟用朗讀功能
这将尝试用最新的游戏格式储存所有数据来达到优化世界的效果。取决于世界的状况，这可能会花费不少时间。一旦完成，进行游戏时可能会更流畅，但你的世界将不再与旧版游戏兼容。你确定要继续吗？	這項操作將嘗試以最新的遊戲資料格式最佳化您的世界。視情況可能會用上一段很長的時間。完成後，您的世界可能會更順暢，但將不再相容於舊版的遊戲。您確定要繼續嗎？
创建备份并优化	建立備份並最佳化
优化世界	最佳化世界
已更新的区块数：%s	已升級的區塊數：%s
已忽略的区块数：%s	已略過的區塊數：%s
总区块数：%s	總區塊數：%s
%s / %s	%s / %s
统计区块中…	正在計算區塊...
失败了！:(	失敗！:(
即将完成…	正在完成...
即将完成区块的升级…	正在完成區塊升級...
即将完成实体的升级…	正在完成實體升級...
即将完成兴趣点的升级…	正在完成興趣點升級...
升级所有区块中…	正在升級所有區塊...
升级所有实体中…	正在升級所有實體...
升级所有兴趣点中…	正在升級所有興趣點...
正在优化世界“%s”	正在最佳化世界「%s」
高对比度	高對比度
高对比度资源包不可用。	無法使用高對比度資源包。
提高UI控件的对比度。	提高 UI 控制項的對比度。
高对比度方块轮廓	高對比度方塊輪廓
提高选中方块的轮廓对比度。	增強目標方塊的輪廓對比度。
辅助功能指南	協助工具指南
菜单背景模糊程度	選單背景模糊程度
更改菜单背景的模糊程度。	變更選單背景的模糊程度。
复述功能快捷键	朗讀功能快捷鍵
允许使用“Cmd+B”开关复述功能。	允許使用「Cmd + B」開啟及關閉朗讀功能。
允许使用“Ctrl+B”开关复述功能。	允許使用「Ctrl + B」開啟及關閉朗讀功能。
全景图滚动速度	全景圖捲動速度
文本背景	文字背景
全局	全部
文本背景不透明度	文字背景不透明度
辅助功能设置	協助工具設定
允许列入服务器玩家列表	允許伺服器列出您的名稱
服务器可能会公开列出目前在线的玩家。\n若关闭此选项，你的名字将不会显示在此列表中。	伺服器可能會公開列出目前上線的玩家。\n若關閉此選項，您的名稱就不會被列出。
平滑光照	柔和光源
最大	最大值
最小	最小值
关	關閉
十字准星	十字準星
快捷栏	快捷欄
攻击指示器	攻擊顯示計
设备	裝置
系统默认	系統預設值
自动跳跃	自動跳躍
命令提示	指令提示
自动保存指示器	自動儲存指示器
生物群系过渡距离	生態域混合
关（最快）	關閉（最快）
11×11（极高）	11×11（極高）
13×13（显著）	13×13（炫耀）
15×15（最高）	15×15（極限）
3×3（快）	3×3（流暢）
5×5（普通）	5×5（普通）
7×7（高）	7×7（高）
9×9（很高）	9×9（非常高）
聊天设置…	聊天設定...
颜色	顏色
聊天延迟：%s秒	聊天延遲：%s 秒
聊天延迟：无	聊天延遲：無
聚焦高度	聚焦高度
淡化高度	未聚焦高度
行距	行距
网页链接	網址連結
链接提示	連結提示
聊天文本不透明度	聊天欄文字不透明度
聊天文本大小	聊天室文字大小
聊天设置	聊天設定
显示	顯示
仅限命令	只顯示指令
宽度	寬度
%s个区块	%s 區塊
高品质	精緻
流畅	流暢
按键控制…	按鍵設定...
鸣谢与著作权说明…	鳴謝...
受伤抖动效果	受傷抖動效果
受到伤害导致的游戏视角晃动程度。	受到傷害導致遊戲視角晃動的程度。
黑白徽标	黑白標誌
将Mojang Studios加载屏幕的背景颜色更改为黑色。	將 Mojang Studios 載入畫面的背景顏色變更為黑色。
黑暗脉动效果	黑暗波動效果
控制监守者或幽匿尖啸体给予的黑暗脉动效果程度。	控制你會受到多少伏守者與伏聆嘯口造成的黑暗效果脈動。
难度	難易度
简单	簡單
敌对生物会生成，但伤害较低。生命值在饥饿值耗尽后最终会降至5颗心。	生成的敵對生物攻擊力較低。生命值會因為飢餓值耗盡而降低至 5 顆心。
困难	困難
敌对生物会生成，且伤害较高。饥饿值耗尽后最终会饿死。	生成的敵對生物攻擊力較高。生命值會因為飢餓值耗盡而歸零。
极限	極限
普通	普通
敌对生物会生成，且伤害适中。生命值在饥饿值耗尽后最终会降至半颗心。	生成的敵對生物攻擊力一般。生命值會因為飢餓值耗盡而降低至半顆心。
服务器难度	伺服器難易度
和平	和平
不会生成绝大多数敌对生物。饥饿值不会消耗，且生命值会自然恢复。	不會生成敵對生物，只有部分中立生物會生成。飢餓值不會降低，生命值會隨著時間回復。
定向音频	定向音效
经典立体声。	經典立體音效。
通过基于HRTF算法的定向环绕音频来改善立体音效的模拟。需使用与HRTF兼容的音频硬件，推荐在使用时佩戴耳机。	使用基於 HRTF 的定向音效模擬出更生動的 3D 音訊。必須使用相容 HRTF 音訊的硬體，並透過耳機獲得最佳體驗。
离散滚动	離散式捲動
实体渲染距离	實體顯示距離
实体阴影	實體陰影
字体设置…	字型設定...
字体设置	字型設定
强制使用Unicode字体	強制使用 Unicode 字型
视场角	視角廣度
广角	超廣角
中	正常
视场角效果	視角廣度效果
控制游戏机制效果改变视场角的程度。	控制視角廣度隨遊戲狀態效果改變的程度。
%s fps	%s fps
最大帧率	最大 FPS
无限制	無限
全屏	全螢幕
当前分辨率	自動
%s×%s@%sHz（%s位色深）	%s×%s@%s（%s 位元色深）
全屏分辨率	全螢幕解析度
设置不可用	設定無法使用
亮度	亮度
明亮	明亮
昏暗	昏暗
附魔光效闪烁速度	附魔光效閃爍速度
控制附魔物品光效的闪动速度。	控制附魔物品的光效閃動速度。
附魔光效闪烁强度	附魔光效閃爍強度
控制附魔物品光效的透明程度。	控制附魔物品的光效透明程度。
图像品质	畫質
极佳！	極致！
%s画质使用屏幕着色器绘制天气、云以及半透明方块和水后面的粒子。\n这也许会在便携设备和4K显示屏上造成严重的性能负担。	%s 畫質使用畫面著色器來繪製透明方塊與 水後方的天氣、雲以及粒子。\n此選項可能會嚴重影響使用行動裝置或是 4K 解析度時的效能。
高品质画质会为大多数设备平衡性能和质量。\n天气、云和粒子可能不会在半透明方块或水的后面显示。	精緻畫質在大部分裝置的效能與畫面品質間取得平衡。\n天氣、雲和粒子可能無法在透明方塊或水的後方出現。
流畅画质将减少雨雪的可见数量。\n树叶等方块的透明效果将被禁用。	流暢畫質會顯示較少的雨及雪。\n各種方塊（如樹葉）的透明效果將會被停用。
在不受支持的情况下继续	以不受支援的狀態繼續
算了	帶我回上一頁
检测到你的图形设备不支持%s画质选项。\n\n你可以忽略此提示并继续，但如果你依然选择使用%s画质，你的设备将不会受到支持。	您的繪圖裝置被檢測出不受 %s 畫質選項支援。\n\n您可以忽略這則訊息，但是若您選擇 %s 畫質將不會為您的裝置提供支援。
检测到渲染器：[%s]	偵測到的渲染器：[%s]
图形设备不受支持	不受支援的圖形裝置
检测到厂商：[%s]	偵測到的供應商：[%s]
检测到OpenGL版本：[%s]	偵測到的 OpenGL 版本：[%s]
界面尺寸	介面大小
自动	自動
隐藏闪电的闪烁效果	隱藏閃電效果
关闭闪电造成的天空闪烁效果。闪电本身仍将可见。	防止打雷造成天空閃爍。閃電本身依然可見。
隐藏匹配的名称	隱藏相符的名稱
第三方服务器也许会发送非标准格式的聊天消息。\n此设置打开后，被隐藏的玩家将会被根据发言者的名字匹配。	第三方伺服器可能會傳送非標準格式的聊天訊息。\n開啟此選項後，將會依據發言者的名稱相符與否來隱藏玩家。
隐藏闪烁标语	隱藏閃爍標語
隐藏主菜单上的黄色闪烁标语。	隱藏標題畫面中的黃色閃爍標語。
降低帧率	限制 FPS
无操作时	無操作時
若超过1分钟无操作，帧率将被限制至30。9分钟后进一步降至10。	當玩家超過一分鐘沒有進行操作時，將 FPS 限制為 30。再過 9 分鐘後，進一步將其限制為 10。
最小化时	最小化時
仅在游戏窗口最小化时限制帧率。	只在遊戲視窗最小化時限制 FPS。
鼠标反转	滑鼠反轉
反转鼠标X轴	反轉滑鼠 X 軸
反转鼠标Y轴	反轉滑鼠 Y 軸
日本字形变体	日文字形變體
在默认字体中为CJK字符使用日本字形。	在預設字型中為 CJK 字元使用日本字形。
按住	按住
语言…	語言...
（语言翻译不一定100%%准确）	（語言翻譯並不一定是 100%% 精確）
语言翻译不一定100%%准确	語言翻譯並不一定是100%%精確
主手	慣用手
左手	左
右手	右
Mipmap级别	Mipmap 等級
披风	披風
帽子	帽子
外套	外套
左裤腿	左褲管
左袖	左衣袖
右裤腿	右褲管
右袖	右衣袖
滚轮灵敏度	滾輪靈敏度
鼠标设置…	滑鼠設定...
鼠标设置	滑鼠設定
多人游戏设置…	多人遊戲設定...
%s×	%s×
音乐播放频率	音樂頻率
持续	持續
频繁	頻繁
调整游戏世界中音乐播放的频率。	調整遊戲世界中音樂播放的頻率。
复述功能	朗讀功能
复述所有	朗讀全部
复述聊天消息	朗讀聊天欄
不可用	無法使用
复述系统消息	朗讀系統訊息
通知显示时长	通知顯示時長
影响所有通知在屏幕上停留的时长。	影響所有通知在畫面中停留的時間長短。
%s：关	%s：關閉
开	開啟
%s：开	%s：開啟
在线选项…	線上狀態...
在线选项	線上狀態選項
仅显示安全的聊天	僅顯示已受保護的聊天內容
仅显示来自其他玩家的可验证为该玩家发送且未被修改的消息。	僅顯示其他玩家經驗證為本人發出、未經修改的訊息。
管理员用品标签页	管理員物品頁籤
粒子效果	粒子密度
少量	少量
最少	最少
%s：+%s%%	%s：+%s%%
%s：%s%%	%s：%s%%
%s：%spx	%s：%spx
区块构建器	區塊生成器
半阻塞	半阻塞
区块内部的某些行为会导致区块立刻重新编译。这包括放置或破坏方块。	區塊內的部分動作會將該區塊即時重新編譯。其中包括放置或破壞方塊。
全阻塞	全阻塞
附近的区块总会被立刻编译。这可能影响放置或破坏方块时的游戏性能。	永遠即時編譯附近的區塊。此選項在放置或破壞方塊時可能會嚴重影響遊戲效能。
线程化	依執行緒
附近的区块会在并行的线程中编译。这可能导致破坏方块时短暂出现图像空洞。	附近的區塊依執行緒排程平行編譯。此選項在破壞方塊時可能會產生短暫的畫面空洞。
原始输入	原始輸入
Realms新闻与邀请	Realms 新聞及邀請
在标题屏幕上获取Realms新闻和邀请，并在Realms按钮上显示相应图标。	在標題畫面中取得 Realms 新聞及邀請，並在 Realms 按鈕上顯示對應的圖示。
云	雲
云层距离	雲層距離
渲染距离	顯示距離
资源包…	資源包...
同步矿车转动	隨著礦車轉動
是否在矿车转动时同步转动玩家视角。仅在开启“矿车改进”实验性设置的世界中可用。	玩家的視角是否應隨著礦車的轉向而轉動。僅在啟用「礦車改進」實驗性設定的世界中可用。
屏幕扭曲效果	畫面扭曲效果
反胃状态效果和下界传送门所使用的屏幕扭曲效果的强度。\n值较低时，反胃的扭曲效果会被一层绿色的视觉效果替代。	噁心狀態效果和地獄傳送門畫面扭曲的強度。\n數值較低時，噁心效果將被一層綠色的視覺效果取代。
鼠标灵敏度	靈敏度
超高速！！！	超高速！！！
*哈欠*	*哈欠*
显示音乐弹窗	顯示音樂提示
当有歌曲开始播放时显示弹窗。歌曲正在播放时，会在游戏暂停菜单中持续显示同一弹窗。	當歌曲開始播放時會顯示提示。歌曲播放時，遊戲中的暫停選單也會持續顯示相同的提示。
隐藏式字幕	顯示字幕
为游戏中播放的声音启用字幕。	為遊戲中播放的聲音啟用字幕。
模拟距离	模擬距離
自定义皮肤…	外觀自訂...
自定义皮肤	外觀自訂
音乐和声音…	音樂和音效...
音乐和声音选项	音樂和音效選項
疾跑间隔	跑步時間間隔
双击前进键激活疾跑的最大时间间隔，以刻为单位。	按兩下前進鍵開始跑步的最大時間間隔，以刻為單位。
遥测数据…	遙測資料...
数据收集	資料收集
“%s”仅包含必要数据。\n“%s”包含可选数据和必要数据。	「%s」只包含必要資料。\n「%s」包含可選資料和必要資料。
遥测已禁用。	遙測資料已停用。
选项	選項
触屏模式	觸控模式
视频设置…	顯示設定...
视频设置	顯示設定
视角摇晃	走路晃動
垂直同步	垂直同步
Minecraft已耗尽内存。\n\n原因可能是游戏存在漏洞，或分配给Java虚拟机的内存过少。\n\n为避免世界损坏，当前游戏已退出。我们已尝试腾出内存，让你可以回到主菜单并继续游戏，但这不一定奏效。\n\n如果你再次看见此消息，请重启游戏。	Minecraft 記憶體不足。\n\n可能是由於遊戲錯誤，或配置給 Java 虛擬機器的記憶體不足。\n\n為防止世界損毀，已結束目前遊戲。我們已嘗試釋放記憶體，讓您返回主選單並繼續遊玩，但這個方法也可能無法解決問題。\n\n如果您再次看到此訊息，請重新啟動遊戲。
内存溢出！	記憶體不足！
可用	可用
复制包失败	檔案複製失敗
你确定要将这些包添加进Minecraft中吗？	您確定要將下列檔案新增至 Minecraft 嗎？
将文件拖放到这个窗口内来添加包	直接拖曳至此視窗以新增檔案
以下项目不是有效的包，未能执行复制操作：\n %s	下列項目不是有效的資源或資料包，因此未能執行複製操作：\n %s
所添加的内容不是包	加入的項目不是資源或資料包
（请将包放在这里）	（請將檔案置於此處）
不兼容	不相容
这个包是为更新的Minecraft版本所打造的，在此版本可能不会正常工作。	這是為新版本的 Minecraft 所設計，可能無法正確運作。
这个包是为更旧的Minecraft版本所打造的，在此版本可能不会正常工作。	這是為舊版本的 Minecraft 所設計，可能無法正確運作。
你确定要加载此包吗？	您確定要載入此檔案？
这个包已损坏，或是为未知的Minecraft版本所打造的，在此版本可能不会正常工作。	這個資源或資料包已損壞，或為未知版本的 Minecraft 所製作，可能無法正常運作。
（适用于新版本的Minecraft）	（為 Minecraft 較新版本製作）
（适用于旧版本的Minecraft）	（為 Minecraft 較舊版本製作）
（已损坏或不兼容）	（已損毀或不相容）
打开包文件夹	開啟資料夾
已选	已選擇
内置	內建
功能	功能
本地	本機
服务器	伺服器
%s×%s	%s×%s
Kristoffer Zetterstrand	Kristoffer Zetterstrand
Albanian	Albanian
de_aztec	de_aztec
Backyard	Backyard
Sarah Boeving	Sarah Boeving
Baroque	Baroque
Target Successfully Bombed	Target Successfully Bombed
Bouquet	Bouquet
Skull On Fire	Skull On Fire
Bust	Bust
Cavebird	Cavebird
Changing	Changing
Cotán	Cotán
Bonjour Monsieur Courbet	Bonjour Monsieur Courbet
Creebet	Creebet
Dennis	Dennis
Kong	Kong
Mojang	Mojang
Earth	Earth
Endboss	Endboss
Fern	Fern
Fighters	Fighters
Finding	Finding
Fire	Fire
Graham	Graham
Humble	Humble
Kebab med tre pepperoni	Kebab med tre pepperoni
Lowmist	Lowmist
Match	Match
Meditative	Meditative
Orb	Orb
Owlemons	Owlemons
Passage	Passage
Pigscene	Pigscene
Paradisträd	Paradisträd
Pointer	Pointer
Pond	Pond
The Pool	The Pool
Prairie Ride	Prairie Ride
Seaside	Seaside
Mortal Coil	Mortal Coil
Skull and Roses	Skull and Roses
The Stage Is Set	The Stage Is Set
Sunflowers	Sunflowers
sunset_dense	sunset_dense
Tides	Tides
Unpacked	Unpacked
The void	The void
Wanderer	Wanderer
Wasteland	Wasteland
Water	Water
Wind	Wind
Wither	Wither
随机样式	隨機樣式
应为布尔型	應為布林值
无效的布尔型数据，应为“true”或“false”却出现了“%s”	無效的布林值，應為 'true' 或 'false' 但出現了 '%s'
应为双精度浮点型	應為倍精度浮點數
无效的双精度浮点型数据“%s”	無效的倍精度浮點數 '%s'
缺少“%s”	應為 '%s'
应为浮点型	應為單精度浮點數
无效的浮点型数据“%s”	無效的單精度浮點數 '%s'
应为整型	應為整數
无效的整型数据“%s”	無效的整數 '%s'
应为长整型	應為長整數
无效的长整型数据“%s”	無效的長整數 '%s'
引号内的字符串包含无效的转义序列“\%s”	引號字串內的跳脫序列 '\%s' 無效
字符串引号不成对	字串未以引號作結
字符串开端应有引号	字串應以引號開首
无法解析粒子选项：%s	無法剖析粒子選項：%s
未知的粒子：%s	未知的粒子：%s
需要一个实体来执行此命令	需要一個實體來執行這條指令
需要一名玩家来执行此命令	需要一個玩家來執行這條指令
当生效后：	使用時：
未知的谓词：%s	未知的述詞：%s
无法找到具有指定标识符的世界	無法找到具有指定識別碼的世界
权限不足，无法连接至此Realm	權限不足，無法連線至此 Realm
无法快速进入游戏	無法快速進入遊戲
澳大利亚新南威尔士州	澳洲新南威爾斯州
澳大利亚维多利亚州	澳洲維多利亞州
巴西	巴西
印度	印度
美国艾奥瓦州	美國愛荷華州
香港	香港
美国弗吉尼亚州	美國維吉尼亞州
美国北卡罗来纳州	美國北卡羅萊納州
法国	法國
日本东部	日本東部
日本西部	日本西部
韩国	南韓
美国伊利诺伊州	美國伊利諾州
爱尔兰	愛爾蘭
美国得克萨斯州	美國德克薩斯州
新加坡	新加坡
瑞典	瑞典
阿联酋	阿拉伯聯合大公國（阿聯）
英国南部	英國南部
美国犹他州	美國猶他州
荷兰	荷蘭
美国加利福尼亚州	美國加利福尼亞州
美国华盛顿州	美國華盛頓州
自动（取决于Realm所有者的延迟）	自動（取決於 Realms 擁有者的網路延遲）
自动（取决于首个加入会话的玩家）	自動（取決於首位加入遊戲的玩家）
快照当前不支持Realms	快照目前不支援 Realms
未知的配方：%s	未知的配方：%s
请检查你的配方书	查看您的配方手冊
新配方已解锁！	已解鎖新的合成配方！
正在播放：%s	正在播放：%s
尝试恢复	嘗試恢復
无法从之前的状态恢复。	無法從之前的狀態恢復。
恢复成功！	恢復成功！
恢复已完成	恢復完成
缺失文件	缺少檔案
没有问题	沒有問題
尝试读取世界文件夹“%s”时出现以下问题。\n可以尝试从先前的状态恢复此世界，也可以在漏洞追踪器上报告此问题。	嘗試讀取世界資料夾「%s」時發生下列問題。\n可以嘗試從較舊的狀態恢復這個世界，也可以在錯誤追蹤器上回報此問題。
没有可以恢复的状态	沒有可以恢復的狀態
尝试恢复世界中…	正在嘗試恢復世界...
%s的状态：	%s 的狀態：
加载世界失败	無法載入世界
加载世界摘要失败	無法載入世界簡介
检测到损坏的资产	偵測到損壞的資源檔案
重载资源失败	資源重新載入失敗
Programmer Art	Programmer Art
检测到资源包错误	偵測到資源包錯誤
世界指定资源包	世界指定資源
选择资源包	選擇資源包
Minecraft的默认观感	Minecraft 預設的視覺與環境效果
正在下载资源包	正在下載資源包
下载文件中（%s MB）…	正在下載檔案 (%s MB)...
正在发送请求…	正在傳送請求...
无法保存截图：%s	無法儲存螢幕擷取畫面：%s
已将截图保存为%s	已儲存螢幕擷取畫面為 %s
添加服务器	新增伺服器
Minecraft服务器	Minecraft 伺服器
你确定要删除此服务器吗？	你確定要移除這個伺服器嗎？
“%s”将会永久消失！（真的很久！）	「%s」將會永遠消失！（非常久！）
直接连接	直接連線
编辑	編輯
（隐藏）	（隱藏）
刷新	重新整理
加入服务器	加入伺服器
允许作弊	允許作弊
例如/gamemode、/experience等命令	例如 /gamemode 、 /experience 等指令
允许命令	允許指令
清除缓存数据	清除快取資料
创建备份并加载	建立備份後載入
我知道我在做什么！	我知道我在做什麼！
自定义世界已不受支持	自訂世界已不受支援
不支持对存档版本进行降级	不支援世界降級功能
使用“实验性设置”的世界不受支持	使用實驗性設定的世界不受支援
你真的想加载此世界吗？	您確定要載入這個世界嗎？
不巧，我们在这个版本的Minecraft中不支持自定义世界。我们可以继续加载这个世界并保持原状，但任何新生成的地形将不再被自定义。抱歉给你带来不便。	很遺憾我們不支援這個版本的 Minecraft 使用自訂世界。我們依然能完整載入這個世界，但是任何新生成的地形將不沿用自訂的設定。很抱歉造成您的不便！
这个世界上次是在%s版本中打开的，你正在使用%s版本。降低世界的游戏版本可能会导致存档损坏，我们无法保证它可以被加载和运行。如果你仍要继续，请备份该存档。	這個世界最後一次遊玩的版本為 %s，您現在的版本為 %s。降低世界版本可能導致資料毀損，我們無法保證世界能讀取運作。若您仍要繼續，請先進行備份。
这个世界使用的实验性设置可能会随时停止运作。我们无法保证这些设置将来能够加载或运作。务必谨慎！	這個世界使用了隨時可能失效的實驗性設定。我們無法保證它能正常載入或運作。請務必小心謹慎！
这个世界上次是在%s版本中打开的，你正在使用%s版本。请备份你的世界，以防世界崩溃。	這個世界最後遊玩的版本為 %s，您的當前版本為 %s。請先備份以避免損壞您的世界。
奖励箱	獎勵箱
作弊	允許作弊
命令	指令
必须进行转换！	必須被轉換！
此世界必须在较旧版本（比如1.6.4）中打开，以便安全转换	此世界必須先以較舊的版本（如 1.6.4）開啟後才能安全轉換
创建新的世界	建立新的世界
数据包	資料包
读取世界数据中…	正在讀取世界資料...
你确定要删除这个世界吗？	你確定要刪除這個世界嗎？
删除世界失败	無法刪除世界
进行备份	進行備份
已备份：%s	已備份：%s
备份失败	備份失敗
打开备份文件夹	開啟備份資料夾
大小：%s MB	檔案大小：%s MB
导出世界生成设置	匯出世界生成設定
导出失败	匯出失敗
导出成功	已匯出
打开世界文件夹	開啟世界資料夾
重置图标	重設圖示
编辑世界	編輯世界
世界生成器的种子	世界生成種子碼
实验性	實驗性
详细信息	詳細資訊
需要的实验性功能：%s	需要實驗性功能：%s
实验性功能需求	實驗性功能需求
请注意！\n此配置需要使用仍在开发中的功能。你的世界可能会崩溃、损坏或不兼容未来的更新。	請注意！\n此設定需要使用仍在開發中的功能。您的世界可能會崩潰、損壞或在未來的版本中無法運作。
实验性功能警告	實驗性功能警告
实验性内容	實驗性內容
实验性内容，即仍在开发的新功能。请小心，启用这些内容有损坏风险。已开启的实验性内容在创建世界后将无法再关闭。	實驗性內容為可能在未來加入的新功能。請小心它們可能造成損壞。已開啟的實驗性內容無法在建立世界後關閉。
试图加载来自未来版本的世界时发生错误。这本就并非万无一失，很抱歉没能成功。	試圖載入較新版本的世界時發生錯誤。這項操作原本就有其風險，很抱歉無法成功載入。
出错了！	發生錯誤！
与生存模式相同，但无法放置或破坏方块。	與生存模式相同，但不能放置或移除方塊。
与生存模式相同，但无法	與生存模式相同，但無法
放置或者移除方块	增加或移除方塊
创造	創造
无拘无束地探索创造。可以飞行，材料取之不尽，且不受怪物伤害。	沒有限制地創造、建設與探索。你能夠飛行，使用無窮的材料，也不會被怪物傷害。
无限的资源、自由地飞翔	無限資源、自由飛行，
并且能够瞬间破坏方块	而且能夠瞬間破壞方塊
难度锁定为“困难”的生存模式，且死亡后无法重生。	難易度鎖定在「困難」的生存模式。死亡後無法重生。
难度锁定在困难的生存模式	與生存模式相同，但是鎖定在
且只有一条生命	最高難度，而且只有一次生命
旁观	旁觀者
你可以旁观，但不能互动。	你可以觀看但是不能夠觸碰。
你可以旁观，但不能互动	你可以觀看但是不可觸摸
生存	生存
探索未知的世界，尽情建造、收集、合成并与怪物战斗。	探索神秘的世界，盡情建造、收集、合成，並與怪物戰鬥。
探索世界、收集资源、合成道具、	搜索資源、合成、提升
提高等级、补充体力和生命值	等級、生命值和飢餓值
游戏规则	遊戲規則
导入设置	匯入設定
导入设置时出错	匯入設定時發生錯誤
选择设置文件（.json）	選擇設定檔 (.json)
此世界无法在此版本中打开。\n最后一次打开此世界的版本是%s。	這個世界無法在此版本中開啟。\n上次於版本 %s 開啟。
不兼容的版本：%s	不相容的版本：%s
此世界在不兼容的版本上创建，故无法打开。	這個世界使用不相容的版本建立，無法開啟。
创建于不兼容的版本	以不相容的版本建立
无法读取或访问游戏世界存档所在的文件夹！	無法載入或存取遊戲世界存檔所在的資料夾！
加载世界列表中	正在載入世界清單
被另一个正在运行的Minecraft实例锁定	被另一個正在執行的 Minecraft 鎖定
生成结构	生成結構
村庄、沉船等	例如村莊、沉船等等
更多世界选项…	更多世界選項...
重建	重新建立
自定义世界在这个版本的Minecraft中已不受支持。我们可以尝试用同样的种子与选项重建它，但任何自定义的地形都会丢失。抱歉给你带来不便。	這個版本的 Minecraft 已不再支援自訂世界。我們可以試著利用相同的種子碼與屬性重新建立，但任何自訂地形將會遺失。很抱歉為您帶來不便！
尝试重建世界时出错。	試圖重新建立世界時出現了一些問題。
准备资源中…	正在準備資源...
将会保存于：	將被儲存於：
搜索世界	搜尋世界
留空以生成随机种子	若不填則隨機生成種子碼
进入选中的世界	進入所選的世界
存档文件夹：%s	存檔資料夾：%s
选择世界	選擇世界
世界是在更新的版本中被保存的，	世界是以較新的版本儲存，
加载这个世界可能会产生问题！	載入這個世界可能會導致出現問題！
在这个快照中加载它之前，	以目前版本載入之前
不要忘了备份这个世界！	別忘了先備份這個世界。
无法加载世界	無法載入世界
版本：	版本：
仍然加载	依然載入
此世界上次是在%s版本中打开的，在此版本中加载可能会导致数据损坏！	這個世界最後遊玩的版本為 %s，使用目前版本載入可能會導致損壞！
一些使用中的功能已被淘汰并会在将来失效。你确定要继续吗？	有些功能已停止支援，將在未來失效。您確定要繼續嗎？
警告！这些设置使用了已淘汰的功能	警告！這些設定使用了停止支援的功能
这些设置是实验性的，将来可能停止运作。你确定要继续吗？	這些實驗性設定將來可能會失效。您確定要繼續嗎？
警告！这些设置使用了实验性功能	警告！這些設定使用了實驗性功能
设备上的存储空间不足。\n运行游戏时磁盘空间不足可能会导致世界损坏。	裝置儲存空間不足。\n在磁碟空間不足時遊玩，可能會導致世界損毀。
警告！磁盘空间不足！	警告！磁碟空間不足！
编辑告示牌消息	編輯告示牌文字
已入睡玩家的数量不足以跳过夜晚	入睡的玩家數目不足以跳過這個夜晚
%s/%s名玩家已入睡	%s/%s 的玩家正在睡覺
今夜将在睡梦中度过	正在睡夢中度過今晚
只允许有单个槽位，实际为“%s”	僅接受單一欄位，當前值 '%s'
未知的槽位“%s”	未知的欄位 '%s'
键不能为空	鍵值不能為空
应为二进制数	應為二進位數字
应为十进制数	應為十進位數字
应为浮点数	應為浮點數
字符字面量长度应为%s	字元字面值長度應為 %s
应为十六进制数	應為十六進位數字
应为整数	應為整數
应为非负数	應為非負數
应为数字或布尔型	應為數字或布林值
应为表示有效UUID的字符串	應為表示有效 UUID 的字串
应为有效的无引号字符串	應為有效的無引號字串
不允许使用非有限数的数值	不允許使用非有限數的數值
无效的数组元素类型	無效的陣列元素類型
无效的Unicode字符名称	無效的 Unicode 字元名稱
无效的Unicode字符码位：%s	無效的 Unicode 字元編碼：%s
无效的字符串内容	無效的字串內容
无引号字符串不能以数字0-9、+或-开头	無引號字串不能以數字 0-9、+ 或 - 開頭
十进制数不能以0开头	十進位數字不能以 0 開頭
不存在的操作：%s	不存在的操作：%s
解析数字失败：%s	無法剖析數字：%s
数字的开头和结尾不允许使用下划线字符	數字的開頭和結尾不允許使用底線字元
环境	環境音效／環境
方块	方塊
敌对生物	敵對生物
主音量	主音量
音乐	音樂
友好生物	友好生物
唱片机/音符盒	唱片機／音階盒
用户界面	UI
复述功能/语音	朗讀功能／語音
天气	天氣
关闭菜单	關閉選單
按下一个键来选择命令，再按一次来使用它。	按下任意鍵以選擇指令，再按一次該按鍵以使用它
传送到队伍成员	傳送至隊伍成員
选择一支队伍作为传送目标	選擇一個隊伍作為傳送目標
传送到玩家	傳送至玩家
选择一名玩家作为传送目标	選擇一位玩家作為傳送目標
通用	一般
繁殖动物次数	動物繁殖數
鞘翅滑行距离	鞘翅飛行距離
鸣钟次数	敲鐘次數
坐船移动距离	坐船航行距離
清洗盔甲次数	清洗的盔甲數量
清洗旗帜次数	清洗的旗幟數量
潜影盒清洗次数	界伏盒清洗次數
已攀爬距离	攀爬距離
潜行距离	蹲行距離
吸收的伤害	吸收的傷害量
盾牌抵挡的伤害	盾牌抵擋的傷害總量
造成伤害	造成傷害總量
造成伤害（被吸收）	造成傷害（被吸收）
造成伤害（被抵挡）	造成傷害（被抵銷）
抵挡的伤害	抵銷的傷害量
受到伤害	承受傷害總量
死亡次数	死亡次數
物品掉落	丟棄物品數量
吃掉的蛋糕片数	已吃掉的蛋糕片數量
物品附魔次数	物品附魔數量
摔落高度	掉落高度
炼药锅装水次数	鍋釜填滿次數
捕鱼数	捕獲魚量
飞行距离	飛行距離
骑乘快乐恶魂移动距离	騎快樂幽靈移動距離
骑马移动距离	騎馬移動距離
搜查发射器次数	發射器搜索次數
搜查投掷器次数	投擲器搜索次數
搜查漏斗次数	漏斗搜索次數
与铁砧交互次数	鐵砧使用次數
与信标交互次数	烽火台使用次數
与高炉交互次数	高爐使用次數
与酿造台交互次数	釀造台使用次數
与营火交互次数	營火使用次數
与制图台交互次数	製圖台使用次數
与工作台交互次数	工作台使用次數
与熔炉交互次数	熔爐使用次數
与砂轮交互次数	砂輪使用次數
与讲台交互次数	講台使用次數
与织布机交互次数	紡織機使用次數
与锻造台交互次数	鍛造台使用次數
与烟熏炉交互次数	煙燻爐使用次數
与切石机交互次数	切石機使用次數
跳跃次数	跳躍次數
游戏退出次数	離開遊戲次數
坐矿车移动距离	乘坐礦車距離
生物击杀数	生物擊殺數
木桶打开次数	木桶開啟次數
箱子打开次数	儲物箱開啟次數
末影箱打开次数	終界箱開啟次數
潜影盒打开次数	界伏盒開啟次數
骑猪移动距离	騎豬移動距離
音符盒播放次数	音階盒演奏次數
播放唱片数	唱片播放
游戏时长	遊戲時間
玩家击杀数	玩家擊殺數
盆栽种植数	盆栽放置數量
触发袭击次数	突襲觸發次數
袭击胜利次数	擊敗突襲次數
躺在床上的次数	睡覺次數
潜行时间	潛行時間
疾跑距离	跑步距離
骑炽足兽移动距离	騎熾足獸移動距離
游泳距离	游泳距離
村民交互次数	與村民對話次數
击中标靶次数	擊中標靶次數
自上次死亡	距離上次死亡
自上次入眠	距離上次睡覺
世界打开时间	世界開啟時間
村民交易次数	與村民交易次數
陷阱箱触发次数	陷阱儲物箱觸發次數
音符盒调音次数	音階盒調音次數
从炼药锅取水次数	從鍋釜取水次數
水面行走距离	水面上的行走距離
行走距离	行走距離
水下行走距离	水面下的行走距離
损坏次数	損壞次數
合成次数	合成次數
丢弃个数	丟棄數量
你杀死了%s个%s	你殺死過 %s 隻%s
你从来没有杀死过%s	你沒有殺死過%s
%s杀死了你%s次	你被%s殺死過 %s 次
你从来没有被%s杀死过	你沒有被%s殺死過
开采次数	挖掘次數
拾起个数	拾起數量
使用次数	使用次數
探测	偵測
加载	載入
自定义数据标签名	自訂資料標籤名稱
探测结构大小和位置：	偵測結構的大小與位置：
角落：%s	角落：%s
数据：%s	資料：%s
加载：%s	載入：%s
保存：%s	儲存：%s
包括实体：	包含實體：
结构完整性及种子	結構完整度及種子碼
结构完整性	結構完整性
结构种子	結構種子碼
无效的结构名“%s”	無效的結構名稱 '%s'
不存在名为“%s”的结构 	沒有名為 '%s' 的結構
结构“%s”的加载位置已就绪	結構 '%s' 的位置已準備就緒
成功从“%s”中加载结构	已從 '%s' 載入結構
角落模式	角落
数据模式	資料
加载模式	載入
保存模式	儲存
角落模式 — 位置和大小标记	角落模式 ─ 位置及大小記號
数据模式 — 游戏逻辑标记	資料模式 ─ 遊戲邏輯記號
加载模式 — 从文件中加载	載入模式 ─ 從檔案載入
保存模式 — 写入文件	儲存模式 ─ 寫入檔案
相对位置	相對位置
相对X坐标	X 軸相對位置
相对Y坐标	Y 軸相對位置
相对Z坐标	Z 軸相對位置
无法保存结构“%s”	無法儲存結構 '%s'
成功将结构保存为“%s”	已將結構儲存為 '%s'
显示隐形方块：	顯示隱形方塊：
显示边框：	顯示定界框：
结构大小	結構大小
结构X轴大小	X 軸結構大小
结构Y轴大小	Y 軸結構大小
结构Z轴大小	Z 軸結構大小
无法检测结构大小。请放置与结构名称对应的角落结构方块	無法偵測結構大小。請添加與結構名稱對應的角落
“%s”的大小已成功检测	已成功偵測 '%s' 的大小
严格放置：	嚴格放置：
结构名称	結構名稱
怪异的噪声	毛骨悚然的聲響
紫水晶：叮铃	紫水晶叮噹作響
紫水晶：共振	紫水晶共振
铁砧：被毁	鐵砧被破壞
铁砧：着陆	鐵砧落地
铁砧：使用	使用鐵砧
木桶：关闭	木桶關閉
木桶：打开	木桶開啟
信标：激活	烽火台啟動
信标：嗡嗡作响	烽火台嗡嗡作響
信标：失效	烽火台關閉
信标：选择效果	選取烽火台效果
蜂蜜：滴落	蜂蜜滴落
蜜蜂：入巢	蜜蜂進入蜂箱
蜜蜂：离巢	蜜蜂離開蜂箱
剪刀：刮削	剪刀刮削
蜜蜂：工作	蜜蜂工作
钟：回响	鐘鳴
钟：响起	鐘聲
垂滴叶：折下	懸葉草下垂
垂滴叶：升起	懸葉草回彈
高炉：噼啪作响	高爐劈啪聲
酿造台：冒泡	釀造台冒泡聲
气泡：破裂	氣泡破裂
气泡：上浮	氣泡上浮
气泡：飞升	氣泡推升
气泡：旋转	氣泡翻滾
气泡：骤降	氣泡捲入
按钮：咔哒	按鈕咔嗒聲
蛋糕：吧唧	蛋糕擠壓聲
营火：噼啪作响	營火劈啪聲
蜡烛：噼啪作响	蠟燭劈啪聲
蜡烛：熄灭	蠟燭熄滅聲
箱子：关闭	儲物箱關閉
箱子：锁上	儲物箱鎖上
箱子：开启	儲物箱開啟
紫颂花：凋零	歌萊花凋謝
紫颂花：生长	歌萊花生長
比较器：模式变更	比較器咔嗒聲
堆肥桶：清空	清空堆肥箱
堆肥桶：填充	填入堆肥箱
堆肥桶：堆肥	堆肥箱堆肥
潮涌核心：激活	海靈核心啟動
潮涌核心：涌动	海靈核心脈動
潮涌核心：攻击	海靈核心攻擊
潮涌核心：失效	海靈核心關閉
铜灯：熄灭	銅燈熄滅
铜灯：亮起	銅燈亮起
活板门：关闭	地板門關閉
活板门：打开	地板門開啟
合成器：合成	合成器合成物品
合成器：合成失败	合成器合成失敗
嘎枝之心：咕哝	嘎枝之心咕噥聲
嘎枝之心：苏醒	嘎枝之心甦醒
干枯声	乾燥聲
饰纹陶罐：装入	飾紋陶罐被填充
饰纹陶罐：晃动	飾紋陶罐晃動
饰纹陶罐：碎裂	飾紋陶罐碎裂
物品：被射出	物品射出
发射器：发射失败	發射器發射失敗
门：嘎吱作响	門嘎吱作響
干燥声	乾燥聲
失水恶魂：补水	乾癟幽靈補水聲
失水恶魂：浸泡	乾癟幽靈浸泡聲
失水恶魂：恢复	乾癟幽靈恢復
风声	風聲
附魔台：使用	使用附魔台
末地传送门：开启	終界傳送門開啟
末影之眼：嵌入	嵌上終界之眼
眼眸花：闭合	擬目花閉合
眼眸花：沙沙作响	擬目花沙沙聲
眼眸花：张开	擬目花張開
栅栏门：嘎吱作响	柵欄門嘎吱作響
火：噼啪作响	火劈啪聲
火：熄灭	火焰熄滅聲
萤火虫：嗡嗡	螢火蟲嗡嗡聲
蝌蚪：孵化	蝌蚪孵化
熔炉：噼啪作响	熔爐劈啪聲
方块：被破坏	方塊破壞聲
某物：摔落到方块上	某物掉落在方塊上
脚步声	腳步聲
方块：损坏中	正在破壞方塊
方块：被放置	方塊放置聲
砂轮：使用	使用砂輪
植物：被修剪	修剪植物
告示牌：晃动	告示牌晃動
从蜂蜜块滑下	從蜂蜜塊上滑下
熔岩：迸裂	熔岩冒泡聲
熔岩：嘶嘶声	熔岩滋滋聲
拉杆：拉动	控制桿咔嗒聲
音符盒：播放	播放音階盒
活塞：移动	活塞被推動
熔岩：滴落	熔岩滴落
熔岩：滴入炼药锅	熔岩滴入鍋釜
水：滴落	水滴落
水：滴入炼药锅	水滴入鍋釜
钟乳石：塌落	鐘乳石砸落
传送门：呼啸	傳送門颼颼聲
传送门：噪声消散	傳送門噪音消退
传送门：噪声渐响	傳送門噪音增強
压力板：咔哒	壓力板咔嗒聲
剪刀：雕刻	剪刀切割
红石火把：熄灭	紅石火把嘶嘶聲
重生锚：呼啸	重生錨颼颼聲
重生锚：充能	重生錨被充能
重生锚：耗能	重生錨消耗
重生锚：设置出生点	重生錨設定重生點
沙沙声	沙聲
幽匿块：冒泡	伏聆冒出氣泡
幽匿块：蔓延	伏聆蔓延
幽匿催发体：催发	伏聆觸媒催發
幽匿感测体：颤动	伏聆振測器振動
幽匿感测体：停息	伏聆振測器停止振動
幽匿尖啸体：尖啸	伏聆嘯口尖嘯
展示架：激活	展示架啟動
展示架：取消激活	展示架復原
物品：交换	交換物品
物品：放置	放置物品
潜影盒：关闭	界伏盒關閉
潜影盒：开启	界伏盒開啟
锻造台：使用	使用鍛造台
烟熏炉：烟熏	煙燻爐冒煙
嗅探兽蛋：裂开	嗅探獸蛋破裂
嗅探兽蛋：孵化	嗅探獸蛋孵化
嗅探兽：下蛋	嗅探獸下蛋
海绵：吸水	海綿吸水
浆果：弹出	漿果彈出
活板门：嘎吱作响	地板門嘎吱作響
不祥之物：准备	不祥物品準備聲
试炼刷怪笼：噼啪作响	試煉生怪磚劈啪聲
不祥试炼刷怪笼：噼啪作响	不祥劈啪聲
试炼刷怪笼：不祥涌动	試煉生怪磚被不祥壟罩
试炼刷怪笼：关闭	試煉生怪磚關閉
试炼刷怪笼：充能	試煉生怪磚充能
试炼刷怪笼：喷出物品	試煉生怪磚彈出物品
试炼刷怪笼：开启	試煉生怪磚開啟
不祥之物：掉落	不祥物品掉落聲
不祥之物：出现	不祥物品出現聲
试炼刷怪笼：生成生物	試煉生怪磚生成生物
绊线：连接	絆線連接
绊线：咔哒	絆線咔嗒聲
绊线：断开	絆線分離
宝库：燃起	寶庫燃起
宝库：噼啪作响	寶庫劈啪聲
宝库：关闭	寶庫關閉
宝库：熄灭	寶庫熄滅聲
宝库：喷出物品	寶庫彈出物品
宝库：解锁	寶庫解鎖
宝库：解锁失败	寶庫拒絕物品
宝库：打开	寶庫開啟
宝库：拒绝已奖励玩家	寶庫拒絕玩家
水：流动	流水聲
海绵：烘干	海綿烘乾
书：被放入	放置書
附魔书：被放入	放置附魔書
书：被取出	取走書
附魔书：被取出	取走附魔書
荆棘：反刺	尖刺刺傷聲
悦灵：搜寻	悅靈搜尋
悦灵：渴求	悅靈渴望
悦灵：死亡	悅靈死亡
悦灵：受伤	悅靈受傷
悦灵：嬉笑	悅靈咯咯笑
悦灵：愉悦	悅靈喜悅
悦灵：投掷	悅靈投擲
犰狳：呼噜	犰狳呼嚕聲
鳞甲：被刷落	鱗甲刷落聲
犰狳：死亡	犰狳死亡
犰狳：进食	犰狳進食
犰狳：受伤	犰狳受傷
犰狳：自卫	犰狳保護自己
犰狳：着陆	犰狳落地
犰狳：窥视	犰狳窺視
犰狳：蜷缩	犰狳蜷縮
犰狳：脱落鳞甲	犰狳掉落鱗甲
犰狳：伸展	犰狳伸展
某物：着地	物體掉落
箭：击中	箭矢擊中聲
箭：击中玩家	擊中玩家
箭：被射出	射出箭矢
美西螈：攻击	六角恐龍攻擊
美西螈：死亡	六角恐龍死亡
美西螈：受伤	六角恐龍受傷
美西螈：啾啾	六角恐龍鳴叫
美西螈：溅起水花	六角恐龍濺起水花
美西螈：游泳	六角恐龍游泳
蝙蝠：尖声叫	蝙蝠聲
蝙蝠：死亡	蝙蝠死亡
蝙蝠：受伤	蝙蝠受傷
蝙蝠：起飞	蝙蝠飛翔聲
蜜蜂：嗡嗡	蜜蜂嗡嗡聲
蜜蜂：死亡	蜜蜂死亡
蜜蜂：受伤	蜜蜂受傷
蜜蜂：愤怒地嗡嗡叫	蜜蜂憤怒地嗡嗡作響
蜜蜂：高兴地嗡嗡叫	蜜蜂快樂地嗡嗡作響
蜜蜂：刺蛰	蜜蜂螫咬
烈焰人：呼吸	烈焰使者吐息
烈焰人：噼啪作响	烈焰使者劈啪聲
烈焰人：死亡	烈焰使者死亡
烈焰人：受伤	烈焰使者受傷
烈焰人：射击	烈焰使者發射
划船	划船
沼骸：咯咯声	沼骸喀啦聲
沼骸：死亡	沼骸死亡
沼骸：受伤	沼骸受傷
旋风人：蓄力	旋風使者蓄力
旋风人：死亡	旋風使者死亡
旋风人：反弹	旋風使者反彈
旋风人：受伤	旋風使者受傷
旋风人：飞行	旋風使者飛行
旋风人：呼啸	旋風使者呼嘯
旋风人：吸气	旋風使者吸氣
旋风人：跳跃	旋風使者跳躍
旋风人：着陆	旋風使者落地
旋风人：射击	旋風使者發射
旋风人：滑行	旋風使者滑行
旋风人：旋转	旋風使者旋轉
风弹：爆裂	風彈爆裂
骆驼：呼噜	駱駝呼嚕聲
骆驼：冲刺	駱駝衝刺
骆驼：恢复体力	駱駝體力恢復
骆驼：死亡	駱駝死亡
骆驼：进食	駱駝進食
骆驼：受伤	駱駝受傷
鞍：装备	裝上鞍
骆驼：坐下	駱駝坐下
骆驼：站起	駱駝起身
骆驼：脚步声	駱駝踏步
骆驼：踏沙	駱駝踏沙
猫：喵~	貓叫聲
猫：求食	貓討食
猫：死亡	貓死亡
猫：进食	貓進食
猫：嘶嘶声	貓嘶嘶聲
猫：受伤	貓受傷
猫：呼噜声	貓呼嚕叫
鸡：咯咯叫	雞叫聲
鸡：死亡	雞死亡
鸡：下蛋	雞下蛋
鸡：受伤	雞受傷
鳕鱼：死亡	鱈魚死亡
鳕鱼：扑腾	鱈魚拍打
鳕鱼：受伤	鱈魚受傷
铜傀儡：死亡	銅魔像死亡
铜傀儡：受伤	銅魔像受傷
铜傀儡：放置物品	銅魔像放置物品
铜傀儡：无法放置物品	銅魔像無法放置物品
铜傀儡：取出物品	銅魔像拾起物品
铜傀儡：无法取出物品	銅魔像無法拾起物品
铜傀儡：出现	銅魔像出現
铜傀儡：旋转头部	銅魔像轉頭
铜傀儡：锈化	銅魔像鏽化
牛：哞~	牛哞聲
牛：死亡	牛死亡
牛：受伤	牛受傷
牛：被挤奶	牛被擠出鮮奶
嘎枝：注视	嘎枝凝視
嘎枝：嘎吱作响	嘎枝嘎吱作響
嘎枝：攻击	嘎枝攻擊
嘎枝：静息	嘎枝平復
嘎枝：碎裂	嘎枝崩解
嘎枝：驻足	嘎枝停止
嘎枝：显现	嘎枝顯現
嘎枝：被击打	嘎枝被擊中
嘎枝：抽搐	嘎枝抽搐
嘎枝：移动	嘎枝移動
苦力怕：死亡	苦力怕死亡
苦力怕：受伤	苦力怕受傷
苦力怕：嘶~	苦力怕嘶嘶聲
海豚：啾啾	海豚啾啾聲
海豚：吹口哨	海豚吹哨
海豚：攻击	海豚攻擊
海豚：死亡	海豚死亡
海豚：进食	海豚進食
海豚：受伤	海豚受傷
海豚：跃起	海豚跳躍
海豚：嬉戏	海豚嬉鬧
海豚：溅起水花	海豚濺水
海豚：游泳	海豚游泳
驴：嘶叫	驢子叫聲
驴：嘶鸣	驢子嘶鳴
驴：装备箱子	為驢子裝上儲物箱
驴：死亡	驢子死亡
驴：进食	驢子進食
驴：受伤	驢子受傷
驴：跳跃	驢子跳躍
溺尸：呻吟	沉屍咕嚕聲
溺尸：死亡	沉屍死亡
溺尸：受伤	沉屍受傷
溺尸：投掷三叉戟	沉屍投擲三叉戟
溺尸：脚步声	沉屍腳步聲
溺尸：游泳	沉屍游泳
鸡蛋：飞出	雞蛋擲出
远古守卫者：低鸣	遠古深海守衛叫聲
远古守卫者：弹跳	遠古深海守衛拍打聲
远古守卫者：诅咒	遠古深海守衛施咒
远古守卫者：死亡	遠古深海守衛死亡
远古守卫者：扑腾	遠古深海守衛拍擊聲
远古守卫者：受伤	遠古深海守衛受傷
末影龙：咆哮	終界龍咆哮聲
末影龙：死亡	終界龍死亡
末影龙：拍打翅膀	終界龍擊翅聲
末影龙：吼叫	終界龍吼叫
末影龙：受伤	終界龍受傷
末影龙：射击	終界龍發射火球
末影之眼：掉落	終界之眼掉落
末影之眼：射出	終界之眼擲出
末影珍珠：飞出	終界珍珠擲出
末影人：低鸣	終界使者低鳴聲
末影人：死亡	終界使者死亡
末影人：受伤	終界使者受傷
末影人：尖叫	終界使者尖叫
末影人：喊叫	終界使者大聲嘶吼
末影人：传送	終界使者瞬移聲
末影螨：窜动	終界蟎竄動
末影螨：死亡	終界蟎死亡
末影螨：受伤	終界蟎受傷
唤魔者：咕哝	喚魔者嘀咕
唤魔者：施法	喚魔者施咒
唤魔者：欢呼	喚魔者歡呼
唤魔者：死亡	喚魔者死亡
唤魔者：受伤	喚魔者受傷
唤魔者：准备攻击	喚魔者準備攻擊
唤魔者：准备召唤	喚魔者準備召喚
唤魔者：准备施咒	喚魔者準備施咒
尖牙：咬合	尖牙咬擊
获得经验	獲得經驗值
烟花：爆裂	煙火爆炸
烟花：发射	煙火發射
烟花：闪烁	煙火閃爍
溅起水花	水濺聲
浮漂：收回	浮標收回
浮漂：溅起水花	浮標濺水聲
浮漂：甩出	浮標投出
狐狸：愤怒	狐狸發怒
狐狸：吱吱叫	狐狸吱叫
狐狸：撕咬	狐狸啃咬
狐狸：死亡	狐狸死亡
狐狸：进食	狐狸進食
狐狸：受伤	狐狸受傷
狐狸：尖声叫	狐狸尖叫聲
狐狸：打鼾	狐狸打鼾
狐狸：嗅探	狐狸嗅氣
狐狸：吐出	狐狸吐出
狐狸：传送	狐狸傳送
青蛙：咕呱	青蛙呱呱叫
青蛙：死亡	青蛙死亡
青蛙：进食	青蛙進食
青蛙：受伤	青蛙受傷
青蛙：产卵	青蛙產卵
青蛙：跳跃	青蛙跳躍
燃烧	燃燒
死亡	死亡
啜饮	飲用聲
进食	進食
爆炸	爆炸聲
某物：受伤	物體受傷
某物：摔倒	物體跌落
游泳	游泳
恶魂：哭泣	地獄幽靈哭泣聲
恶魂：死亡	地獄幽靈死亡
恶魂：受伤	地獄幽靈受傷
恶魂：射击	地獄幽靈射擊
小恶魂：咕咕	小幽靈咕咕聲
小恶魂：死亡	小幽靈死亡
小恶魂：受伤	小幽靈受傷
小恶魂：出现	小幽靈出現
荧光物品展示框：填充	填充螢光物品展示框
荧光物品展示框：被破坏	取下螢光物品展示框
荧光物品展示框：被放置	放置螢光物品展示框
荧光物品展示框：清空	清空螢光物品展示框
荧光物品展示框：转动	螢光物品展示框咔嗒聲
发光鱿鱼：游泳	螢光魷魚游泳
发光鱿鱼：死亡	螢光魷魚死亡
发光鱿鱼：受伤	螢光魷魚受傷
发光鱿鱼：喷墨	螢光魷魚噴墨
山羊：咩~	山羊咩叫聲
山羊：死亡	山羊死亡
山羊：进食	山羊進食
山羊：断角	山羊角斷裂
山羊：受伤	山羊受傷
山羊：跳跃	山羊跳躍聲
山羊：被挤奶	山羊被擠出鮮奶
山羊：跺脚	山羊重踏聲
山羊：冲撞	山羊衝撞聲
山羊：喊叫	山羊吼叫聲
山羊：脚步声	山羊腳步聲
守卫者：低鸣	深海守衛叫聲
守卫者：弹跳	深海守衛拍打聲
守卫者：射击	深海守衛發射
守卫者：死亡	深海守衛死亡
守卫者：扑腾	深海守衛拍擊聲
守卫者：受伤	深海守衛受傷
快乐恶魂：哼唱	快樂幽靈哼唱聲
快乐恶魂：死亡	快樂幽靈死亡
挽具：装备	帽鞍裝備聲
快乐恶魂：就绪	快樂幽靈就緒
快乐恶魂：停下	快樂幽靈停下
快乐恶魂：受伤	快樂幽靈受傷
挽具：卸下	帽鞍卸除聲
疣猪兽：咆哮	豬布獸吼叫
疣猪兽：怒吼	豬布獸憤怒地吼叫
疣猪兽：攻击	豬布獸攻擊
疣猪兽：转化为僵尸疣猪兽	豬布獸轉化為豬屍獸
疣猪兽：死亡	豬布獸死亡
疣猪兽：受伤	豬布獸受傷
疣猪兽：退缩	豬布獸撤退
疣猪兽：脚步声	豬布獸腳步聲
马：嘶鸣	馬嘶鳴
马铠：装备	裝上馬鎧
马：呼吸	馬呼吸聲
马：死亡	馬死亡
马：进食	馬進食
马：奔腾	馬跑步聲
马：受伤	馬受傷
马：跳跃	馬跳躍
尸壳：低吼	屍殼呻吟聲
尸壳：转化为僵尸	屍殼轉變為殭屍
尸壳：死亡	屍殼死亡
尸壳：受伤	屍殼受傷
幻术师：咕哝	幻術師嘀咕
幻术师：施法	幻術師施咒
幻术师：死亡	幻術師死亡
幻术师：受伤	幻術師受傷
幻术师：分影	幻術師分影
幻术师：准备失明法术	幻術師準備盲眼咒
幻术师：准备分影法术	幻術師準備分影咒
铁傀儡：攻击	鐵魔像攻擊
铁傀儡：受损	鐵魔像破裂
铁傀儡：死亡	鐵魔像死亡
铁傀儡：受伤	鐵魔像受傷
铁傀儡：修复	鐵魔像修復
物品：损坏	物品損壞
物品：被拾起	撿起物品
物品展示框：填充	填充物品展示框
物品展示框：被破坏	取下物品展示框
物品展示框：被放置	放置物品展示框
物品展示框：清空	清空物品展示框
物品展示框：转动	物品展示框咔嗒聲
拴绳结：被破坏	取下拴繩
拴绳结：被系上	繫上拴繩
电闪	雷擊聲
雷鸣	雷聲隆隆
羊驼：吼叫	駱馬叫聲
羊驼：怒吼	駱馬怒吼
羊驼：装备箱子	為駱馬裝上儲物箱
羊驼：死亡	駱馬死亡
羊驼：进食	駱馬進食
羊驼：受伤	駱馬受傷
羊驼：喷射唾沫	駱馬呸
羊驼：脚步声	駱馬踏步
羊驼：被装饰	駱馬被裝飾
岩浆怪：死亡	岩漿立方怪死亡
岩浆怪：受伤	岩漿立方怪受傷
岩浆怪：挤压	岩漿立方怪啪搭聲
矿车：哐啷作响	礦車哐啷聲
矿车：在水中哐啷作响	礦車水下哐啷聲
矿车：行进	礦車移動
哞菇：转化	哞菇轉變
哞菇：进食	哞菇進食
哞菇：被挤奶	哞菇被擠出鮮奶
哞菇：被挤出谜之炖菜	哞菇被擠出可疑的奶
骡：鸣叫	騾子叫聲
骡：嘶鸣	騾子嘶鳴
骡：装备箱子	為騾子裝上儲物箱
骡：死亡	騾子死亡
骡：进食	騾子進食
骡：受伤	騾子受傷
骡：跳跃	騾子跳躍
画：被破坏	取下繪畫
画：被放置	放置繪畫
熊猫：发怒	貓熊發怒
熊猫：喘息	貓熊喘氣
熊猫：撕咬	貓熊啃咬
熊猫：哀鸣	貓熊哀鳴
熊猫：死亡	貓熊死亡
熊猫：进食	貓熊進食
熊猫：受伤	貓熊受傷
熊猫：鼻痒	貓熊鼻子發癢
熊猫：打喷嚏	貓熊打噴嚏
熊猫：脚步声	貓熊腳步聲
熊猫：呜咽	貓熊嗚咽
鹦鹉：说话	鸚鵡說話
鹦鹉：死亡	鸚鵡死亡
鹦鹉：进食	鸚鵡進食
鹦鹉：扑翼	鸚鵡振翅
鹦鹉：受伤	鸚鵡受傷
鹦鹉：呼吸	鸚鵡吐息
鹦鹉：咯咯声	鸚鵡喀啦聲
鹦鹉：呼啸	鸚鵡呼嘯
鹦鹉：嘎吱作响	鸚鵡嘎吱作響
鹦鹉：嘶~	鸚鵡嘶嘶聲
鹦鹉：呻吟	鸚鵡咕嚕聲
鹦鹉：低鸣	鸚鵡呻吟聲
鹦鹉：咆哮	鸚鵡咆哮聲
鹦鹉：窜动	鸚鵡竄動
鹦鹉：咕哝	鸚鵡嘀咕
鹦鹉：哭泣	鸚鵡哭泣聲
鹦鹉：低吼	鸚鵡呻吟聲
鹦鹉：挤压	鸚鵡啪搭聲
鹦鹉：尖声叫	鸚鵡尖叫聲
鹦鹉：哼叫	鸚鵡哼氣
鹦鹉：呼噜	鸚鵡呼嚕聲
鹦鹉：窥视	鸚鵡潛伏
鹦鹉：嘶嘶	鸚鵡嘶嘶聲
鹦鹉：恼人	鸚鵡惱怒
鹦鹉：低语	鸚鵡嘀咕聲
鹦鹉：暗笑	鸚鵡咯咯笑
鹦鹉：愤怒	鸚鵡發怒
幻翼：尖声叫	夜魅尖叫聲
幻翼：撕咬	夜魅啃咬
幻翼：死亡	夜魅死亡
幻翼：振翅	夜魅振翅
幻翼：受伤	夜魅受傷
幻翼：俯冲	夜魅俯衝
猪：哼叫	豬叫聲
猪：死亡	豬死亡
猪：受伤	豬受傷
猪灵：端详物品	豬布林鑑賞物品
猪灵：哼叫	豬布林哼氣
猪灵：愤怒地哼叫	豬布林憤怒地哼氣
猪灵：庆祝	豬布林慶祝
猪灵：转化为僵尸猪灵	豬布林轉化為殭屍化豬布林
猪灵：死亡	豬布林死亡
猪灵：受伤	豬布林受傷
猪灵：羡慕地哼叫	豬布林嫉妒地哼氣
猪灵：退缩	豬布林撤退
猪灵：脚步声	豬布林腳步聲
猪灵蛮兵：哼叫	豬布林蠻兵哼氣
猪灵蛮兵：愤怒地哼叫	豬布林蠻兵憤怒地哼氣
猪灵蛮兵：转化为僵尸猪灵	豬布林蠻兵轉化為殭屍化豬布林
猪灵蛮兵：死亡	豬布林蠻兵死亡
猪灵蛮兵：受伤	豬布林蠻兵受傷
猪灵蛮兵：脚步声	豬布林蠻兵腳步聲
掠夺者：咕哝	掠奪者嘀咕
掠夺者：欢呼	掠奪者歡呼
掠夺者：死亡	掠奪者死亡
掠夺者：受伤	掠奪者受傷
暴击	暴擊
击退攻击	擊退攻擊
重击	重攻擊
横扫攻击	橫掃攻擊
轻击	弱攻擊
打嗝	打嗝
玩家：死亡	玩家死亡
玩家：冻伤	玩家凍傷
玩家：受伤	玩家受傷
玩家：溺水	玩家溺水
玩家：燃烧	玩家燃燒
玩家：升级	玩家升級聲
玩家：传送	玩家傳送
北极熊：低吼	北極熊低吼
幼年北极熊：哼哼	幼年北極熊低哼
北极熊：死亡	北極熊死亡
北极熊：受伤	北極熊受傷
北极熊：咆哮	北極熊吼叫
玻璃瓶：碎裂	瓶子碎裂聲
玻璃瓶：扔出	擲瓶聲
河豚：收缩	河豚消氣
河豚：膨胀	河豚充氣
河豚：死亡	河豚死亡
河豚：扑腾	河豚拍打
河豚：受伤	河豚受傷
河豚：刺蛰	河豚螫人
兔子：吱吱叫	兔子叫聲
兔子：攻击	兔子攻擊
兔子：死亡	兔子死亡
兔子：受伤	兔子受傷
兔子：跳动	兔子跳躍
劫掠兽：呼噜	劫毀獸咕嚕聲
劫掠兽：撕咬	劫毀獸啃咬
劫掠兽：欢呼	劫毀獸歡呼
劫掠兽：死亡	劫毀獸死亡
劫掠兽：受伤	劫毀獸受傷
劫掠兽：咆哮	劫毀獸咆哮聲
劫掠兽：脚步声	劫毀獸腳步聲
劫掠兽：眩晕	劫毀獸暈眩
鲑鱼：死亡	鮭魚死亡
鲑鱼：扑腾	鮭魚拍打
鲑鱼：受伤	鮭魚受傷
绵羊：咩~	綿羊叫聲
绵羊：死亡	綿羊死亡
绵羊：受伤	綿羊受傷
潜影贝：窥视	界伏蚌潛伏
潜影贝：闭合	界伏蚌關閉
潜影贝：死亡	界伏蚌死亡
潜影贝：受伤	界伏蚌受傷
潜影贝：打开	界伏蚌開啟
潜影贝：射击	界伏蚌發射
潜影贝：传送	界伏蚌瞬移
潜影弹：爆炸	界伏彈爆炸
潜影弹：碎裂	界伏彈破裂
蠹虫：嘶嘶	蠹魚嘶嘶聲
蠹虫：死亡	蠹魚死亡
蠹虫：受伤	蠹魚受傷
骷髅：咯咯声	骷髏喀啦聲
骷髅：转化为流浪者	骷髏轉化為流髑
骷髅：死亡	骷髏死亡
骷髅：受伤	骷髏受傷
骷髅：射击	骷髏射箭
骷髅马：嘶叫	骷髏馬叫聲
骷髅马：死亡	骷髏馬死亡
骷髅马：受伤	骷髏馬受傷
骷髅马：跳跃	骷髏馬跳躍
骷髅马：游泳	骷髏馬游泳
史莱姆：攻击	史萊姆攻擊
史莱姆：死亡	史萊姆死亡
史莱姆：受伤	史萊姆受傷
史莱姆：挤压	史萊姆啪搭聲
嗅探兽：死亡	嗅探獸死亡
嗅探兽：挖掘	嗅探獸挖掘
嗅探兽：站起	嗅探獸起身
嗅探兽：丢下种子	嗅探獸挖出種子
嗅探兽：进食	嗅探獸進食
嗅探兽：愉悦	嗅探獸愉悅
嗅探兽：受伤	嗅探獸受傷
嗅探兽：呼噜	嗅探獸呼嚕聲
嗅探兽：嗅闻	嗅探獸嗅聞
嗅探兽：搜寻	嗅探獸尋找
嗅探兽：嗅探	嗅探獸嗅探
嗅探兽：脚步声	嗅探獸腳步聲
雪傀儡：死亡	雪人死亡
雪傀儡：受伤	雪人受傷
雪球：飞出	投擲雪球聲
蜘蛛：嘶嘶	蜘蛛嘶嘶聲
蜘蛛：死亡	蜘蛛死亡
蜘蛛：受伤	蜘蛛受傷
鱿鱼：游泳	魷魚游泳聲
鱿鱼：死亡	魷魚死亡
鱿鱼：受伤	魷魚受傷
鱿鱼：喷墨	魷魚噴墨
流浪者：咯咯声	流髑喀啦聲
流浪者：死亡	流髑死亡
流浪者：受伤	流髑受傷
炽足兽：死亡	熾足獸死亡
炽足兽：进食	熾足獸進食
炽足兽：颤鸣	熾足獸顫抖
炽足兽：受伤	熾足獸受傷
炽足兽：啾啾	熾足獸吵鬧
炽足兽：退缩	熾足獸退卻
蝌蚪：死亡	蝌蚪死亡
蝌蚪：扑腾	蝌蚪拍打
蝌蚪：成长	蝌蚪成長
蝌蚪：受伤	蝌蚪受傷
TNT：嘶嘶作响	TNT 嗞嗞作響
热带鱼：死亡	熱帶魚死亡
热带鱼：扑腾	熱帶魚拍打
热带鱼：受伤	熱帶魚受傷
海龟：啾啾	海龜啾啾聲
海龟：死亡	海龜死亡
幼年海龟：死亡	幼年海龜死亡
海龟蛋：破裂	海龜蛋破碎
海龟蛋：裂开	海龜蛋裂開
海龟蛋：孵化	海龜蛋孵化
海龟：受伤	海龜受傷
幼年海龟：受伤	幼年海龜受傷
海龟：产卵	海龜產卵
海龟：爬行	海龜爬行
幼年海龟：爬行	幼年海龜爬行
海龟：游泳	海龜游泳
恼鬼：恼人	惱鬼惱怒
恼鬼：尖叫	惱鬼尖叫
恼鬼：死亡	惱鬼死亡
恼鬼：受伤	惱鬼受傷
村民：喃喃自语	村民嘀咕聲
村民：欢呼	村民歡呼
村民：死亡	村民死亡
村民：受伤	村民受傷
村民：拒绝	村民拒絕
村民：交易	村民交易
盔甲匠：工作	製甲師工作
屠夫：工作	屠夫工作
制图师：工作	製圖師工作
牧师：工作	神職人員工作
农民：工作	農夫工作
渔夫：工作	漁夫工作
制箭师：工作	製箭師工作
皮匠：工作	皮匠工作
图书管理员：工作	圖書管理員工作
石匠：工作	石匠工作
牧羊人：工作	牧羊人工作
工具匠：工作	工具匠工作
武器匠：工作	武器匠工作
村民：同意	村民同意
卫道士：低语	衛道士嘀咕聲
卫道士：欢呼	衛道士歡呼
卫道士：死亡	衛道士死亡
卫道士：受伤	衛道士受傷
流浪商人：喃喃自语	流浪商人嘀咕聲
流浪商人：死亡	流浪商人死亡
流浪商人：隐身	流浪商人消失
流浪商人：喝奶	流浪商人飲用鮮奶
流浪商人：饮用药水	流浪商人喝藥水
流浪商人：受伤	流浪商人受傷
流浪商人：拒绝	流浪商人拒絕
流浪商人：现身	流浪商人出現
流浪商人：交易	流浪商人交易
流浪商人：同意	流浪商人同意
监守者：愤怒地呻吟	伏守者怒吼
监守者：呻吟	伏守者呻吟
监守者：狂怒	伏守者發怒
监守者：击中	伏守者擊打聲
监守者：死亡	伏守者死亡
监守者：掘地	伏守者掘地
监守者：现身	伏守者浮現
监守者：心跳声	伏守者心跳聲
监守者：受伤	伏守者受傷
监守者：察觉到某物	伏守者注意到聲響
监守者：愤怒地察觉到某物	伏守者被注意到的聲響激怒
监守者：接近	伏守者接近
监守者：逼近	伏守者靠近
监守者：迫近	伏守者貼近
监守者：咆哮	伏守者咆哮
监守者：嗅闻	伏守者嗅聞
监守者：发射音波	伏守者音爆
监守者：蓄力	伏守者蓄力
监守者：脚步声	伏守者腳步聲
监守者：卷须颤动	伏守者的觸鬚抖動
风弹：飞行	風彈飛行
女巫：暗笑	女巫咯咯笑
女巫：欢呼	女巫歡呼
女巫：死亡	女巫死亡
女巫：饮用药水	女巫喝藥水
女巫：受伤	女巫受傷
女巫：投掷	女巫投擲
凋灵：愤怒	凋零怪發怒
凋灵：死亡	凋零怪死亡
凋灵：受伤	凋零怪受傷
凋灵：攻击	凋零怪攻擊
凋灵：解放	凋零怪被釋放
凋灵骷髅：咯咯声	凋零骷髏喀啦聲
凋灵骷髅：死亡	凋零骷髏死亡
凋灵骷髅：受伤	凋零骷髏受傷
狼：喘息	狼喘氣聲
狼：吠叫	狼嗥叫
狼：死亡	狼死亡
狼：嚎叫	狼嚎聲
狼：受伤	狼受傷
狼：摇动	狼甩動身體
狼：呜咽	狼嗚咽聲
僵尸疣猪兽：咆哮	豬屍獸吼叫
僵尸疣猪兽：怒吼	豬屍獸憤怒地吼叫
僵尸疣猪兽：攻击	豬屍獸攻擊
僵尸疣猪兽：死亡	豬屍獸死亡
僵尸疣猪兽：受伤	豬屍獸受傷
僵尸疣猪兽：脚步声	豬屍獸腳步聲
僵尸：低吼	殭屍呻吟聲
门：晃动	門晃動
门：毁坏	門損壞
僵尸：转化为溺尸	殭屍轉變為沉屍
僵尸：死亡	殭屍死亡
海龟蛋：被踩踏	海龜蛋被踩踏
僵尸：受伤	殭屍受傷
僵尸：感染	殭屍傳染
僵尸马：嘶叫	殭屍馬叫聲
僵尸马：死亡	殭屍馬死亡
僵尸马：受伤	殭屍馬受傷
僵尸村民：低吼	殭屍村民呻吟聲
僵尸村民：哀嚎	殭屍村民喊叫
僵尸村民：撕心裂肺	殭屍村民抽鼻
僵尸村民：死亡	殭屍村民死亡
僵尸村民：受伤	殭屍村民受傷
僵尸猪灵：呼噜	殭屍化豬布林呼嚕聲
僵尸猪灵：愤怒地呼噜	殭屍化豬布林憤怒的呼嚕聲
僵尸猪灵：死亡	殭屍化豬布林死亡
僵尸猪灵：受伤	殭屍化豬布林受傷
不祥之兆：显现	不祥之兆顯現
袭击：迫在眉睫	突襲迫在眉睫
不祥试炼：迫在眉睫	不祥試煉迫在眉睫
不祥号角：鸣响	不祥號角響起
盔甲：装备	穿上裝備
锁链盔甲：碰擦	鎖鏈盔甲裝備聲
铜盔甲：哐咚	銅製盔甲鏗鏘聲
钻石盔甲：碰擦	鑽石盔甲裝備聲
鞘翅：沙沙作响	鞘翅沙沙聲
金盔甲：叮当	黃金盔甲裝備聲
铁盔甲：铿锵	鐵製盔甲裝備聲
皮革盔甲：摩擦	皮革盔甲裝備聲
下界合金盔甲：铿锵	獄髓盔甲裝備聲
海龟壳：咕咚	戴上海龜殼
狼铠：装备	狼鎧配戴聲
狼铠：滑落	狼鎧滑落
斧：刮削	斧頭刮削
斧：削皮	斧頭剝皮
骨粉：沙沙作响	骨粉播撒聲
书页：沙沙作响	書頁沙沙聲
书：放置	擺上書本
玻璃瓶：倒空	瓶子淨空
玻璃瓶：装满	裝瓶
刷子：刷扫中	正在刷拭
刷子：刷扫沙砾中	正在刷拭礫石
刷子：刷扫沙砾完毕	刷拭礫石完成
刷子：刷扫沙子中	正在刷拭沙子
刷子：刷扫沙子完毕	刷拭沙子完成
铁桶：倒空	倒空鐵桶
铁桶：装满	填充鐵桶
美西螈：被装起	六角恐龍被撈起
鱼：被捕获	捕獲魚
蝌蚪：被捕获	捕獲蝌蚪
收纳袋：倒空	束口袋清空
物品：装入袋中	裝入物品
收纳袋：已满	束口袋已滿
物品：从袋中取出	取出物品
作物：种植	種下作物
弩：蓄力	弩上弦
弩：装填	弩裝填
弩：发射	弩發射
染料：染色	染色
呼啸声	滑翔聲
火焰弹：呼啸	火球颼颼聲
打火石：点火	打火石咔嗒聲
荧光墨囊：涂抹	螢光墨囊噴濺
山羊角：吹奏	吹奏山羊角
锄：犁地	鋤頭耕地
吞咽	吞嚥
马铠：滑落	馬鎧滑落
墨囊：涂抹	墨囊噴濺
拴绳：断开	斷開拴繩
拴绳：系上	繫上拴繩
拴绳：解开	解開拴繩
地毯：滑落	地毯滑落
磁石指针：绑定磁石	磁石羅盤綁定磁石
重锤：猛击	重錘重擊聲
鞍：滑落	鞍滑落
剪刀：咔嚓	剪刀咔嗒聲
剪刀：剪断	剪刀剪斷聲
盾牌：格挡	盾牌格擋
锹：压地	鏟子夷平
望远镜：缩小	望遠鏡收合
望远镜：放大	望遠鏡伸展
图腾：发动	圖騰觸發
三叉戟：突刺	三叉戟突刺
三叉戟：振动	三叉戟振動
三叉戟：收回	三叉戟返回
三叉戟：突进	三叉戟突進
三叉戟：铿锵	三叉戟鏗鏘聲
三叉戟：电闪雷鸣	三叉戟雷聲劈啪
狼铠：损坏	狼鎧損壞
狼铠：裂开	狼鎧破裂
狼铠：受损	狼鎧受損
狼铠：被修复	狼鎧修復
灵魂：逸散	靈魂逃脫
地图：绘制	繪製地圖
氧气值：减少	氧氣值消耗
织布机：使用	使用紡織機
切石机：使用	使用切石機
雨：落下	雨聲
从含有符号链接的文件夹中加载世界可能导致风险，尤其是在你不清楚链接目标内容时。请访问%s了解更多信息。	繼續操作前請知悉，從包含符號連結的資料夾中載入世界可能會有風險。請前往 %s 了解更多資訊。
继续操作前请知晓，加载含有符号链接的包可能会有风险。请访问%s了解更多信息。	繼續操作前請知悉，載入包含符號連結的資源或資料包可能會有風險。請前往 %s 了解更多資訊。
继续操作前请知晓，从含有符号链接的文件夹中加载世界可能会有风险。请访问%s了解更多信息。	繼續操作前請知悉，從包含符號連結的資料夾中載入世界可能會有風險。請前往 %s 了解更多資訊。
更多信息	更多資訊
世界文件夹包含符号链接	世界資料夾包含符號連結
添加的包中含有符号链接	加入的資源或資料包存在符號連結
世界文件夹中含有符号链接	世界資料夾包含符號連結
总是碰撞	碰撞啟用
禁用碰撞	碰撞停用
队伍间碰撞	碰撞其他隊伍
队伍内碰撞	碰撞我方隊伍
未知的队伍“%s”	未知的隊伍 '%s'
对别队隐藏	隱藏其他隊伍
对本队隐藏	隱藏我方隊伍
始终隐藏	永不顯示
了解达成进度前后发生的事情有助于我们更好了解及改进游戏流程。	了解達成進度後發生的事情，有利於我們更好了解並改進遊戲過程。
达成进度	達成進度
此事件会测量游戏启动各个阶段的时长以帮助我们找到游戏启动的性能优化点。	此事件透過測量遊戲啟動階段的各段執行時長，可幫助我們找到需要改進啟動效能的地方。
游戏加载时间	遊戲載入時間
%s（可选）	%s（可選）
%s（可选，已禁用）	%s（可選 – 已停用）
了解Minecraft的整体性能概况，可以帮助我们针对各种机型和操作系统调整与优化游戏。 \n游戏版本信息也包含在其中，以帮助我们比较Minecraft新版本的性能概况。	了解 Minecraft 整體的效能概況，可以幫助我們針對各類裝置及作業系統調整並改進遊戲。 \n遊戲版本資訊也包含在內，以便我們比較新版本 Minecraft 的效能概況。
性能指标	效能指標
%s（必要）	%s（必要）
对我们而言，了解加入世界所需的时长，以及这一时长随着时间推移会如何变化是很重要的。比如，当我们加入新功能或进行较大的技术更改时，我们需要知道这对加载时间有何影响。	對我們而言，了解加入世界所需的時長，以及此時長隨時間推移的變化情形是十分重要的。舉例來說，當我們加入新功能或是進行較大的技術性改動時，我們會需要這些資訊來了解這些改動對載入時間有何影響。
世界加载时间	世界載入時間
了解玩家玩Minecraft时的细节（例如游戏模式、客户端或服务端是否被修改，以及游戏版本）有助于我们在游戏更新时注重改进玩家最关心的部分。\n世界加载事件将同世界卸载事件一起用于计算游戏会话的持续时长。	了解玩家如何遊玩 Minecraft （例如遊戲模式、伺服器和用戶端是否為原版、遊戲版本等資訊），可以讓我們專注於遊戲更新，用來改善玩家最關心的地方。\n世界載入事件和世界卸載事件一起用於計算遊戲時間。
世界加载	世界載入
此事件与世界加载事件用于计算世界会话的持续时间。\n持续时间（以秒和刻为单位）在世界会话结束时（退回到标题屏幕，或从服务器断开连接）测量。	此事件與世界載入事件用於計算遊戲時長。\n持續時間（單位為秒和刻）在遊玩結束時（回到標題畫面，或是從伺服器中斷連線）測量。
世界卸载	世界卸載
游戏时间（刻）	遊戲時間（刻）
进度ID	進度 ID
客户端ID	用戶端 ID
客户端是否被修改	用戶端是否為原版
专用内存（kB）	專屬記憶體（kB）
事件时间戳（UTC）	事件時間戳記（UTC）
帧率样本（FPS）	畫面更新率樣本（FPS）
游戏版本	遊戲版本
启动器名称	啟動器名稱
启动引导时间（毫秒）	啟動引導時間（毫秒）
加载屏幕显示时间（毫秒）	載入畫面顯示時間（毫秒）
窗口开启前时间（毫秒）	視窗開啟前時間（毫秒）
总计加载时间（毫秒）	總載入時間（毫秒）
Minecraft会话ID	Minecraft Session ID
是否为新的世界	是否為新的世界
样本数	樣本數量
操作系统	作業系統
可选择加入	可選擇加入
平台	平台
Realm地图内容（小游戏名称）	Realms 地圖內容（小遊戲名稱）
渲染用时样本	繪製時間樣本
自加载后的时间（秒）	自載入後的時間（秒）
服务端是否被修改	伺服器是否為原版
服务器类型	伺服器類型
自加载后的时间（刻）	自載入後的時間（刻）
已使用的内存	使用的記憶體
用户ID	使用者 ID
世界加载时间（毫秒）	世界載入時間（毫秒）
世界会话ID	世界 Session ID
隐私声明	隱私權聲明
打开我的数据	開啟我的統計資料
我同意发送可选的遥测数据	我同意傳送可選的遙測資料
包含的数据	包含的資料
收集这些数据可以让我们了解与玩家有关的实际情况，以便帮助我们改进Minecraft。\n你也可以发送其他反馈来帮助我们持续改进Minecraft。	收集以下資料有助於讓我們了解與玩家相關的實際情形，進而幫助我們改進 Minecraft。\n您也可以傳送額外的意見回饋來幫助我們持續改進 Minecraft。
遥测数据收集	遙測資料收集
属性%s应为%s，实际为%s	屬性 %s 應為 %s，但實際為 %s
缺少方块属性，属性%s应为%s	缺少方塊屬性，屬性 %s 應為 %s
实体%s测试失败：%s	實體 %s 測試失敗：%s
实体%s测试失败：%s，应为：%s，实际为：%s	實體 %s 測試失敗：%s，應為：%s，但實際為：%s
方块应为%s，实际为%s	方塊應為 %s，但實際為 %s
方块应为#%s中之一，实际为%s	方塊應在 #%s 中，但實際為 %s
容器应包含：%s	容器應含有：%s
容器应含有单个：%s	容器應含有單個：%s
容器应为空	容器應為空
缺少%s	應為 %s
%2$s, %3$s, %4$s周围应存在%1$s	%s 應存在於 %s, %s, %s 周圍
应有%s个类型为%s的实体，实际有%s个	類型為 %2$s 的實體應有 %1$s 個，但找到了 %3$s 個
实体数据应为：%s，实际为：%s	實體資料應為：%s，但實際為：%s
%s的实体数据不匹配	%s 的實體資料不相符
%s应有%s %s效果	%s 應有效果 %s %s
实体物品栏中应包含%s	實體物品欄中應含有 %s
实体应持有%s	實體應持有 %s
%s应存在于测试中	%s 應存在於測試中
%s不应接触%s, %s, %s（相对位置：%s, %s, %s）	%s 不應與 %s, %s, %s 接觸（相對位置：%s, %s, %s）
%s应接触%s, %s, %s（相对位置：%s, %s, %s）	%s 應與 %s, %s, %s 接觸（相對位置：%s, %s, %s）
应为%s类型的物品	應為類型 %s 的物品
应为%s个%s类型的物品，实际为%s个	類型為 %2$s 的物品應有 %1$s 個，但找到了 %3$s 個
满足失败条件	滿足失敗條件
发现非预期的方块类型：%s	找到非預期的方塊類型：%s
缺少方块实体	缺少方塊實體
%s，位于%s, %s, %s（相对位置：%s, %s, %s），%s刻	%s，位於 %s, %s, %s（相對位置：%s, %s, %s），時間為 %s 刻
条件已在%s刻时触发	條件已在 %s 刻時觸發
条件未触发	條件未觸發
成功于无效的刻：应为%s	在無效刻時成功：應為 %s
测试在序列完成前超时	測試在序列完成前已逾時
设置测试生物群系失败	無法設定測試的生態域
创建实体%s失败	無法建立實體 %s
状态错误。应为%s，实际为%s	狀態錯誤。應為 %s，但實際為 %s
为%s放置测试结构失败	無法為 %s 放置測試結構
%s，时间为%s刻	%s，時間為 %s 刻
尚未放置结构时执行了测试	在放置結構前執行了測試
未在%s刻内成功或失败	未在 %s 刻內成功或失敗
在%s刻内没有序列完成	在 %s 刻內沒有序列完成
%2$s, %3$s, %4$s周围应仅存在一个%1$s，实际为%5$s个	%2$s, %3$s, %4$s 周圍應只有一個 %1$s，但找到了 %5$s 個
方块不应为%s	方塊不應為 %s
%s不应存在	%s 不應存在
物品不应为类型%s	物品不應為類型 %s
未知的内部错误：%s	未知的內部錯誤：%s
错误的方块实体类型：%s	錯誤的方塊實體類型：%s
测试结构缺少%s方块	測試結構缺少 %s 方塊
%s方块过多	%s 方塊過多
无效的时限（%s），刻数必须为正数	無效的時間限制 (%s) - 刻數須為正數
消息：	訊息：
日志输出	記錄
启动	啟動
接受模式 - 接受（部分）测试的成功	接受模式 ─ 接受測試（部分）成功
失败模式 - 使测试失败	失敗模式 ─ 使測試失敗
日志输出模式 - 将消息输出到日志	記錄模式 ─ 將紀錄輸出至記錄檔中
启动模式 - 测试的起点	啟動模式 ─ 測試的起點
重置并加载	重設並載入
加载并运行	載入並執行
保存结构	儲存結構
批次：%s	批次：%s
失败：%s	失敗：%s
函数：%s	函數：%s
无效的测试ID	無效的測試 ID
此测试不存在	測試不存在
结构：%s	結構：%s
基于方块的测试	基於方塊的測試
内置函数测试	內建函數測試
实体：	實體：
存在未定义的测试，无法在%s, %s, %s处运行测试实例	存在未被定義的測試，無法在 %s, %s, %s 處執行測試實例
没有测试结构，无法在%s, %s, %s处运行测试实例	沒有測試結構，無法在 %s, %s, %s 處執行測試實例
无法保存%s, %s, %s处测试实例的测试结构模板	無法在 %s, %s, %s 處儲存測試實例的測試結構模板
[无效]	[無效]
测试重置成功：%s	測試重設成功：%s
旋转角度：	旋轉角度：
测试结构大小	測試結構大小
正在启动测试%s	正在啟動測試 %s
测试实例ID	測試實例 ID
检测到32位系统：未来将需要64位系统，使用32位系统可能将无法进行游戏！	偵測到 32 位元系統：未來需求為 64 位元系統時，您可能無法遊玩！
Minecraft不久后需要64位系统才能运行，届时你将无法使用该设备进行游戏或使用Realms服务。你需要自行取消所有Realms订阅。	Minecraft 在不久後僅支援 64 位元系統，您將無法在此裝置遊玩或使用 Realms。您需要自行取消 Realms 的任何訂閱。
检测到32位系统	偵測到 32 位元系統
© Mojang AB 请勿二次分发！	Mojang AB 版權所有。請勿二次轉發！
你必须在进行在线游戏前更改名称	您遊玩線上遊戲前必須更改您的名稱
你的账户已被永久封禁，无法进行多人游戏	您帳號的線上遊玩功能已被永久停權
你的账户已被暂时封禁，无法进行多人游戏	您帳號的線上遊玩功能已被暫時停權
多人游戏（局域网）	多人遊戲（區域網路）
多人游戏（第三方服务器）	多人遊戲（第三方伺服器）
多人游戏（Realms）	多人遊戲（Realms）
前缀，%s%2$s 然后是 %s 和 %1$s 最后是 %s 还有 %1$s！	Prefix, %s%2$s again %s and %1$s lastly %s and also %1$s again!
%%s %%%s %%%%s %%%%%s	%%s %%%s %%%%s %%%%%s
% 你好	 % 你好
%s 你好	你好 %s
你好，世界！	你好，世界！
紫水晶质	紫水晶材質
铜质	銅材質
钻石质	鑽石材質
绿宝石质	綠寶石材質
金质	金材質
铁质	鐵材質
青金石质	青金石材質
下界合金质	獄髓材質
石英质	石英材質
红石质	紅石材質
树脂质	樹脂材質
单击鼠标右键收纳物品	按下右鍵以放入物品
使用收纳袋	使用束口袋
配方书能提供帮助	配方手冊能對您有所幫助
合成木板	合成木材
敲击木头来收集它	揍它來採集木頭
找到一棵树	尋找一棵樹
使用你的鼠标来转动	使用您的滑鼠來轉向
环顾四周	環顧四周
用%s来跳跃	用 %s 來跳躍
用%s、%s、%s和%s来移动	用 %s、%s、%s 和 %s 來移動
按下%s	按 %s
打开你的物品栏	開啟您的物品欄
按住%s	按住 %s
摧毁树木	摧毀這棵樹
按%s打开	按下 %s 以開啟
